OOOHOOOOOOOOOOOHOOOOOOOHOOOHOOOOOHOOOOOOOHOOOOOOOOOOOOOHOOOHOOOOOHOOOOOOOOOOOOOHOOOOOHOOOOOOOOOOOHOH
HHOHOHHHHHOHHHOHHHHHOHOHOHOHOHHHHHOHHHOHHHOHHHHHHHOHHHHHOHOHOHHHOHOHHHHHHHOHHHOHOHOHHHOHHHOHHHHHOHOH
OOOHOOOHOOOHOHOOOOOOOHOOOHOOOHOOOHOHOHOOOOOHOOOOOHOOOOOOOHOOOHOHOOOHOOOOOHOHOOOHOHOOOOOHOOOHOOOHOHOH
OHHHHHOHOHHHOHOHHHHHHHHHHHOHHHOHOHOHOHHHHHHHOHOHOHHHHHHHHHHHHHOHHHHHOHOHHHOHOHHHHHHHHHHHOHHHOHOHOHOH
OOOOOOOHOOOHOOOHOOOOOOOHOOOHOOOHOOOHOOOOOOOOOHOHOHOOOOOOOHOOOOOOOOOOOHOHOOOHOOOOOHOOOOOHOHOOOHOOOHOH
HHHHHHHHHHOHHHHHOHHHHHOHHHOHOHHHHHHHHHHHHHHHHHOHOHHHHHHHOHOHHHHHHHOHHHOHOHHHHHHHOHOHHHOHOHHHHHOHHHOH
OOOOOOOOOOOHOOOHOHOOOHOOOHOHOHOOOOOOOHOOOOOHOOOHOOOOOHOOOHOHOHOOOHOHOOOHOHOHOOOHOHOHOOOOOHOOOHOOOOOH
OHHHOHHHHHHHOHOHOHHHOHHHOHOHOHOHOHHHOHOHHHOHOHHHHHHHOHOHHHOHOHOHOHOHHHHHOHOHOHOHOHOHHHHHHHOHOHHHHHOH
OOOHOHOOOOOOOHOOOHOOOHOOOHOHOHOHOOOHOHOHOHOOOHOOOOOHOHOHOOOOOHOHOOOHOOOOOHOOOHOOOHOHOOOOOOOHOOOOOHOH
OHOHHHOHHHHHHHHHHHOHOHOHOHHHOHHHHHOHOHOHOHHHHHOHOHHHOHOHOHHHHHOHHHHHOHOHHHHHHHOHHHOHOHHHHHHHHHHHOHHH
OHOOOOOHOOOHOOOOOOOHOHOHOHOOOHOOOOOHOHOHOOOOOHOHOOOOOHOOOHOOOOOHOOOHOHOHOOOOOHOOOOOHOHOHOOOOOOOHOOOH
OHHHHHHHOHOHHHHHHHOHHHOHHHOHHHOHHHHHOHOHHHHHOHOHHHHHHHOHHHOHHHHHOHOHOHHHOHHHOHHHOHHHOHOHOHHHOHOHHHOH
OHOOOOOOOHOOOOOOOHOOOHOOOOOHOOOHOOOHOOOHOOOOOHOOOOOHOHOOOHOOOOOOOHOHOOOHOHOHOHOOOHOOOHOOOOOHOHOHOHOH
OHOHOHHHHHHHHHHHOHHHOHHHHHHHOHHHOHOHHHHHOHHHOHHHHHOHOHHHOHHHHHHHOHOHHHOHOHOHOHHHOHOHHHHHHHOHOHOHOHOH
OHOHOOOHOOOHOOOHOOOHOOOOOOOHOOOHOHOOOOOOOHOOOHOOOOOHOOOOOHOOOOOHOHOOOHOOOHOHOOOHOHOHOOOHOOOHOHOHOHOH
OHHHHHOHOHOHHHOHHHOHOHHHHHOHHHOHOHHHHHHHOHOHHHOHHHHHOHHHHHOHHHOHHHHHOHHHHHOHHHOHHHOHOHOHHHHHOHOHOHOH
OOOOOHOHOHOOOHOOOOOHOOOHOHOOOHOHOHOOOOOOOHOHOOOHOOOHOOOHOOOHOHOOOHOOOHOOOOOOOHOOOOOHOHOOOHOOOHOHOHOH
HHHHOHOHOHHHOHOHHHHHHHOHOHHHOHOHOHOHHHHHHHHHOHHHOHHHHHOHOHHHOHHHOHOHOHHHOHHHOHHHHHHHOHHHOHOHHHOHOHOH
OOOOOHOOOHOHOHOOOOOOOHOHOOOHOHOHOHOOOOOOOHOOOHOOOHOOOOOHOHOOOOOHOOOHOOOHOHOHOHOOOOOHOOOHOHOHOOOHOHOH
OHHHHHOHHHOHOHHHHHHHOHOHOHOHOHOHHHHHHHOHOHOHHHOHHHOHHHHHOHHHHHOHHHHHHHOHOHOHOHOHHHOHHHOHOHOHOHHHOHOH
OOOHOHOHOOOHOOOHOOOHOOOHOHOOOOOHOOOOOHOHOHOHOOOOOOOOOOOHOOOHOOOHOOOOOOOHOHOOOHOHOOOOOOOHOOOHOOOOOHOH
HHOHOHOHOHOHHHOHOHOHHHHHOHHHHHHHOHHHOHHHOHOHHHHHHHHHHHHHHHOHOHHHOHHHHHHHOHHHOHOHOHHHHHHHHHHHHHHHOHOH
OOOHOHOHOHOOOHOOOHOHOHOOOOOOOHOOOHOOOHOOOHOOOHOOOHOOOHOOOHOHOOOOOOOOOOOHOOOHOOOHOOOHOOOOOHOOOOOHOHOH
OHHHOHOHHHHHOHHHHHOHOHOHHHHHOHOHHHOHHHOHHHHHOHOHOHOHOHOHOHOHOHHHHHHHHHOHOHOHHHHHHHOHOHHHOHOHHHHHOHOH
OHOOOHOOOOOOOHOOOOOHOOOHOOOHOHOOOHOOOHOOOOOHOHOHOOOHOOOHOOOHOHOOOOOHOOOHOHOHOOOOOHOHOOOHOHOOOOOOOHOH
OHOHOHHHHHHHOHOHOHHHHHOHOHOHHHHHOHHHOHOHOHHHOHOHHHHHHHHHHHHHOHOHHHOHOHHHHHOHOHHHOHOHHHOHOHHHHHOHHHOH
OHOHOOOOOHOOOHOHOHOOOHOHOHOOOOOOOHOOOHOHOOOOOOOHOOOOOHOOOOOOOHOHOOOHOHOOOOOHOHOOOHOHOOOHOOOOOHOHOOOH
OHHHHHHHOHOHHHOHHHOHOHHHOHHHHHHHHHOHHHHHOHHHHHHHOHHHOHOHHHHHHHOHOHHHOHHHOHOHOHOHHHHHOHHHHHHHOHHHOHOH
OOOOOOOHOOOOOHOHOOOHOOOOOHOOOOOOOHOOOOOHOOOHOOOHOOOHOOOOOHOOOOOHOHOOOOOOOHOHOHOOOOOHOHOOOOOOOHOOOHOH
HHHHHHOHHHHHHHOHOHHHHHOHHHOHHHHHOHHHHHOHHHHHOHOHHHHHHHHHHHOHHHHHOHHHHHOHHHHHOHHHHHOHOHHHOHHHHHOHHHHH
OOOHOOOHOOOOOHOHOHOOOHOHOOOHOOOOOHOOOHOOOHOOOHOOOOOOOOOOOOOHOOOHOOOHOOOHOOOHOHOHOOOHOOOHOOOOOHOHOOOH
OHHHOHHHOHHHOHOHOHOHOHHHOHHHOHHHHHHHOHHHOHOHHHHHHHHHHHHHHHHHHHOHHHOHOHHHOHOHOHOHOHHHHHOHHHHHOHOHOHOH
OHOOOHOOOHOOOOOHOHOHOOOOOOOHOOOHOOOOOOOHOOOHOOOOOOOOOOOOOOOOOOOOOHOHOHOHOHOOOHOHOOOHOOOHOHOOOHOOOHOH
OHOHHHOHHHOHHHHHOHOHHHHHHHHHHHOHOHHHHHHHHHHHOHHHHHHHHHHHHHOHOHHHHHOHOHOHOHHHHHOHHHOHOHHHOHOHHHHHHHOH
OHOOOOOHOOOHOOOHOOOOOOOOOHOOOHOHOOOHOOOOOOOOOHOOOHOOOOOOOHOHOHOOOOOHOOOHOOOHOOOOOHOOOHOOOHOOOOOOOOOH
OHHHOHHHHHHHOHOHHHHHHHHHHHOHOHOHHHOHOHHHHHHHHHHHOHOHHHHHOHHHOHOHHHHHHHHHHHOHHHOHHHHHHHHHOHHHHHHHHHOH
OOOOOHOOOOOHOHOOOOOOOOOOOHOHOHOOOHOOOOOOOHOOOOOOOHOOOHOOOOOHOOOOOOOOOHOOOHOOOHOOOOOOOHOOOHOOOHOOOHOH
HHHHHHOHHHOHOHHHHHHHHHHHOHOHOHHHOHHHHHHHOHOHHHHHOHHHOHHHHHOHHHHHHHHHOHOHOHHHOHOHHHOHOHOHOHOHOHOHOHOH
OOOOOOOHOOOHOOOOOHOHOOOOOOOHOOOHOOOOOOOHOOOHOHOOOOOHOOOHOHOOOHOOOOOHOOOHOOOOOHOOOHOHOOOHOOOHOOOHOHOH
OHHHHHHHOHHHHHOHOHOHOHHHHHHHHHOHOHHHHHOHHHHHOHOHHHHHHHOHOHHHOHOHHHHHHHHHHHHHHHOHHHOHHHHHHHHHOHHHHHOH
OHOOOOOHOOOOOHOHOHOOOHOOOHOOOOOHOHOOOHOOOHOOOOOHOOOOOOOHOOOHOHOHOOOOOHOOOOOOOHOHOOOHOOOOOOOOOHOOOHOH
OHOHHHOHHHHHOHOHOHOHHHOHOHHHOHHHHHOHOHHHOHOHHHHHOHHHHHHHOHOHOHOHOHHHOHOHHHHHOHOHOHHHHHHHHHHHHHOHOHOH
OHOOOHOOOHOHOHOHOHOOOHOHOOOHOOOHOOOHOOOOOHOOOHOOOHOOOOOHOHOOOHOOOHOHOHOHOOOHOOOHOOOOOHOOOOOHOOOHOHOH
OHHHOHHHOHOHOHHHOHOHHHOHHHOHHHOHOHHHHHHHOHHHHHOHHHOHOHHHOHHHHHHHOHOHOHOHOHOHHHHHOHHHOHOHHHOHOHHHOHOH
OOOOOOOHOHOHOOOOOHOHOOOOOHOOOHOOOHOHOOOOOHOOOHOHOHOHOOOHOOOOOOOHOOOHOOOHOHOHOOOHOOOHOOOOOHOHOHOHOOOH
OHHHHHHHOHOHHHHHHHOHOHHHHHHHOHHHHHOHOHHHHHOHOHOHOHOHHHOHHHHHHHOHHHHHHHHHOHOHOHOHHHOHHHHHHHOHOHOHHHHH
OOOOOHOOOHOOOOOOOOOHOHOOOOOHOOOHOOOOOOOHOOOHOOOHOOOHOHOOOOOOOOOHOOOOOOOHOHOOOHOHOOOOOHOOOHOOOOOOOHOH
HHHHHHOHOHHHHHHHHHOHOHOHHHOHOHOHHHHHHHOHOHHHHHHHOHHHOHHHHHHHHHHHOHHHHHOHOHHHHHOHOHHHHHOHOHHHHHHHOHOH
OOOOOOOHOHOOOOOOOHOHOHOHOOOHOHOHOOOOOHOHOOOOOHOOOHOOOOOOOHOOOOOOOHOOOHOOOHOOOHOHOHOOOOOHOOOOOOOHOOOH
OHHHHHHHHHOHHHHHOHHHOHOHOHHHHHOHOHHHOHOHHHHHOHOHHHOHOHHHOHHHHHOHHHOHHHHHHHOHHHOHOHOHHHHHHHHHHHOHHHHH
OHOOOOOOOHOOOHOHOOOOOHOHOOOOOHOHOOOHOHOHOOOHOHOHOOOHOHOHOOOOOOOHOHOOOOOOOHOOOOOHOHOHOOOOOHOOOHOOOOOH
OHOHHHHHOHHHOHOHHHHHHHOHHHHHOHOHOHHHOHOHOHHHOHOHHHHHOHOHHHHHHHHHOHOHHHHHOHOHHHHHHHOHOHHHOHOHOHHHHHOH
OOOHOOOOOHOHOHOOOHOOOOOHOOOOOHOOOHOOOHOOOHOOOHOOOOOOOHOOOOOOOOOHOOOOOOOHOOOOOOOOOOOHOHOHOOOHOOOHOOOH
OHHHOHHHOHOHOHHHOHOHHHHHHHOHHHOHHHOHHHHHOHOHHHHHHHHHHHHHOHHHHHOHOHHHHHHHHHHHHHHHHHHHOHOHHHHHHHOHOHHH
OHOOOHOHOOOHOOOHOHOOOOOOOHOHOHOHOHOOOOOHOHOOOOOOOOOHOOOHOHOOOHOOOHOOOOOOOOOOOHOOOOOHOOOHOOOHOHOOOHOH
OHOHHHOHOHHHHHOHOHHHHHHHOHOHOHOHOHHHHHOHHHHHHHHHHHOHOHOHHHOHOHOHHHOHHHHHHHHHOHOHHHHHHHOHOHOHOHHHHHOH
OHOHOOOOOHOOOHOHOOOOOOOHOHOHOOOHOOOOOHOOOOOOOHOOOHOOOHOOOOOHOHOHOOOOOOOOOOOHOHOHOOOOOOOHOHOOOOOOOOOH
OHOHHHHHHHOHOHOHOHHHHHHHOHOHHHOHHHOHHHHHHHOHOHOHOHHHHHHHHHHHOHHHOHHHHHHHHHHHOHOHOHHHHHHHOHHHHHHHHHOH
OHOOOOOHOOOHOOOHOOOOOHOOOHOOOHOOOHOOOOOHOHOHOOOHOHOOOHOOOHOHOOOOOHOOOOOOOOOOOHOHOHOOOHOOOOOOOHOOOOOH
OHHHHHOHOHHHHHHHHHHHOHOHHHHHOHHHOHHHOHOHOHOHHHHHOHOHOHOHOHOHHHHHHHOHHHHHHHHHHHOHOHOHOHHHHHHHOHOHHHHH
OHOOOOOHOHOHOOOOOOOOOHOHOOOHOHOOOOOOOHOOOHOHOOOHOOOHOOOHOHOOOHOOOHOOOHOOOOOHOOOOOHOHOOOOOOOOOHOHOOOH
HHOHHHHHOHOHOHOHHHHHOHOHHHOHOHHHHHHHHHOHHHOHOHHHHHHHHHHHOHOHOHOHOHHHOHOHHHOHOHHHHHOHHHHHHHHHHHOHHHOH
OOOHOOOHOHOOOHOOOOOHOHOOOHOOOOOOOOOHOOOHOOOHOOOOOOOOOOOHOOOHOOOHOHOOOHOHOOOHOHOOOOOHOOOOOOOHOOOHOOOH
OHHHOHOHOHHHHHOHHHOHOHHHOHOHHHHHHHOHHHHHOHHHOHHHHHHHHHOHHHHHHHHHOHOHHHOHOHHHOHHHOHHHHHOHHHOHOHHHOHOH
OOOOOHOHOHOOOHOOOHOHOOOHOHOHOOOOOHOOOOOHOHOHOHOOOOOOOOOOOOOOOOOHOHOHOOOHOOOHOOOHOHOOOHOHOOOHOOOHOHOH
OHHHHHOHOHOHOHOHHHOHHHOHOHHHOHHHOHHHHHOHOHOHOHOHHHHHHHHHOHHHHHHHOHOHHHHHHHOHHHOHOHOHOHOHOHHHHHOHOHOH
OOOHOHOHOOOHOHOHOOOHOOOHOHOOOHOHOOOOOHOOOHOHOHOOOHOOOHOOOHOOOOOOOHOOOOOOOHOOOHOOOHOHOHOHOOOOOHOOOHOH
HHOHOHOHHHHHOHHHOHHHHHOHOHOHHHOHHHHHOHHHHHOHOHHHOHOHOHHHHHOHHHHHHHHHHHHHOHOHOHHHHHOHOHOHHHOHHHHHHHOH
OOOHOHOOOOOHOHOOOHOOOHOHOHOOOHOOOOOHOHOOOHOHOHOHOOOHOHOOOHOOOHOOOHOOOHOOOHOHOOOOOOOHOHOHOOOHOOOHOOOH
OHHHOHHHOHOHOHOHOHOHOHHHOHHHOHOHHHOHOHOHOHOHOHOHHHHHOHOHOHHHOHOHOHHHOHOHHHHHOHHHHHHHOHOHHHHHOHOHOHHH
OOOHOHOOOHOHOOOHOHOHOOOOOHOOOHOOOHOHOOOHOHOOOOOOOOOHOOOHOOOOOHOHOOOOOHOOOOOHOOOOOOOHOOOHOOOOOHOHOOOH
HHOHOHOHHHOHOHHHHHOHHHHHOHOHHHHHOHOHHHHHOHOHHHHHHHOHHHHHHHHHHHOHHHHHOHHHHHOHHHHHHHOHHHOHOHHHHHOHHHOH
OHOHOHOOOHOHOHOOOHOOOOOHOHOOOOOHOHOOOOOHOHOHOOOHOOOHOOOOOOOOOHOOOHOOOHOOOHOOOOOHOOOHOOOHOHOOOHOOOOOH
OHOHOHHHOHHHOHOHOHHHHHOHOHHHHHOHHHOHHHOHOHHHOHOHOHHHHHOHHHHHOHHHOHHHHHOHOHHHHHOHOHHHHHOHOHOHOHHHHHHH
OOOHOOOHOOOOOHOHOOOOOOOHOHOOOHOOOHOHOOOHOOOOOHOHOHOOOOOHOOOHOOOHOOOOOOOHOOOOOHOHOOOOOHOHOOOHOOOHOOOH
OHHHOHOHHHHHHHOHOHHHHHHHOHHHOHHHOHOHOHHHHHHHHHOHOHHHOHHHOHOHHHOHOHHHHHHHHHOHOHOHHHHHOHHHHHHHHHOHHHOH
OHOOOHOOOHOHOOOHOHOOOHOOOOOOOOOHOHOHOOOHOOOOOHOHOOOHOHOHOHOHOOOHOOOHOOOOOHOHOHOHOOOHOOOOOOOOOHOOOHOH
OHOHHHOHOHOHOHHHHHOHOHHHHHOHHHHHOHHHHHOHOHHHOHOHHHOHOHOHOHOHOHHHHHHHOHHHOHOHHHOHOHOHHHOHHHHHOHHHOHOH
OOOHOOOHOHOHOOOHOOOHOOOOOHOHOOOOOHOOOOOHOHOHOHOHOOOOOHOOOHOOOHOOOOOOOHGHOHOOOHOOOHOOOHOHOOOOOHOOOHOH
HHHHOHHHOHOHHHOHOHHHHHHHOHHHOHHHHHOHHHHHOHOHOHOHOHHHHHHHOHHHHHHHOHHHHHOHOHOHOHHHHHHHOHOHHHHHHHOHHHOH
OOOHOOOHOOOHOHOHOOOHOOOHOOOOOHOOOOOHOOOHOHOHOOOHOHOOOOOHOOOOOOOOSHOOOHOOOHOHOOOHOOOOOHOHOOOOOOOHOOOH
OHHHOHOHHHOHOHOHHHOHOHHHHHHHHHOHOHHHOHOHOHOHHHHHOHOHHHOHHHHHHHOHOHHHOHOHHHHHOHOHOHHHHHOHOHHHHHHHOHOH
OHOOOHOOOOOHOHOOOOOHOHOOOOOOOOOHOOOHOHOOOHOOOOOHOHOHOHOOOOOHOOOHOOOHOOOOOOOOOHOHOHOOOOOHOHOOOHOOOHOH
OHOHHHHHHHHHOHHHHHHHOHOHHHHHHHHHHHOHOHHHHHHHOHHHOHOHOHHHHHOHOHHHHHOHHHHHHHHHHHOHOHOHHHOHOHOHHHOHHHOH
OOOHOOOHOOOOOOOHOOOHOHOHOOOHOOOOOOOHOOOHOOOOOHOOOHOOOOOHOOOHOOOHOHOOOOOHOOOHOOOHOHOHOOOHOHOOOOOHOOOH
OHHHOHOHHHHHOHOHOHOHOHOHOHHHOHHHHHOHHHOHOHHHHHOHHHHHHHOHOHHHHHOHOHHHHHOHOHOHOHHHOHHHOHHHOHOHHHHHOHOH
OOOOOHOOOHOOOHOOOHOOOHOHOHOOOHOOOOOHOOOHOHOOOHOOOOOHOOOHOOOOOHOOOOOHOOOHOHOHOOOHOOOHOHOOOHOHOOOOOHOH
HHHHHHHHOHOHHHHHHHHHOHOHOHOHHHHHOHHHOHHHOHOHOHHHHHOHOHHHHHHHOHOHHHHHOHHHOHOHHHHHHHOHOHOHHHHHOHHHHHOH
OOOOOHOOOHOOOOOOOOOHOHOHOHOOOOOHOHOOOHOOOOOHOOOOOOOHOHOOOOOOOHOHOOOHOHOOOHOHOOOOOOOHOHOOOOOHOHOOOOOH
OHOHOHOHHHHHHHHHOHOHHHOHOHHHHHOHOHOHHHHHHHHHHHOHHHHHOHOHHHHHHHOHOHOHOHOHOHOHOHHHHHHHOHHHHHOHOHHHHHOH
OHOHOHOOOOOOOOOHOHOHOOOOOOOHOOOHOHOOOOOOOOOOOHOHOOOHOHOOOHOOOOOHOHOOOHOHOHOHOHOOOHOOOHOOOOOHOOOOOHOH
OHOHOHHHHHHHHHOHHHOHOHHHHHHHOHHHOHHHHHHHHHHHOHOHOHHHOHHHOHOHHHHHOHHHHHHHOHOHOHOHOHOHOHOHHHHHOHHHOHOH
OHOHOOOHOOOOOHOOOHOOOHOOOOOOOHOHOOOOOHOOOHOOOHOOOHOOOHOHOHOOOHOHOOOHOOOOOHOHOOOHOHOHOOOHOOOOOHOOOHOH
OHOHHHOHOHOHHHHHOHHHHHOHHHHHHHOHHHHHOHOHHHOHOHHHHHOHHHOHOHHHOHOHHHOHHHOHHHOHHHHHOHOHHHHHHHHHHHOHHHOH
OHOOOHOHOHOOOOOHOHOOOHOHOOOOOOOHOOOOOOOHOOOHOHOOOHOHOOOHOOOHOOOOOHOOOHOHOHOOOOOOOHOOOHOOOOOOOHOHOOOH
HHHHOHOHOHHHHHOHOHOHOHOHOHHHOHOHOHHHHHHHOHHHHHOHOHOHHHOHHHOHHHHHOHHHOHOHOHHHHHHHHHHHOHOHOHHHOHOHOHHH
OOOOOHOHOHOHOOOHOHOHOHOHOOOHOHOHOHOHOOOOOHOOOHOHOHOOOHOOOHOOOHOOOOOHOOOHOOOHOOOOOOOHOHOHOOOHOHOHOOOH
OHHHHHHHOHOHOHHHOHOHOHOHHHOHOHHHOHOHOHHHHHOHOHOHOHHHOHHHOHHHOHHHHHHHHHHHOHOHOHHHHHOHOHHHHHOHOHOHHHOH
OOOOOOOOOOOHOOOOOOOHOOOHOOOHOOOOOOOHOOOOOOOHOOOHOOOOOOOOOOOHOOOOOOOOOOOOOHOOOOOOOHOOOOOOOOOHOOOHOOOH
HHHHHHHHHHHHHHHHHHHHHHHHHHHHHHHHHHHHHHHHHHHHHHHHHHHHHHHHHHHHHHHHHHHHHHHHHHHHHHHHHHHHHHHHHHHHHHHHHHHH
