OOOOOHOHOOOOOOOHOOOOOHOOOOOOOHOOOOOOOHOOOOOHOOOOOOOHOOOOOOOHOOOOOHOOOOOOOOOOOOOOOOOHOOOOOOOOOHOOOHOH
HHOHOHOHOHOHHHOHOHHHHHOHOHHHOHOHHHHHOHHHOHHHOHHHOHHHOHHHHHOHOHHHOHOHHHHHHHHHHHHHOHOHOHHHHHHHOHOHOHOH
OOOHOHOOOHOHOHOHOOOOOOOHOHOOOOOHOOOHOOOHOOOHOHOHOOOOOOOHOOOHOHOHOOOHOOOOOOOOOHOOOHOHOHOOOOOHOOOHOOOH
OHHHOHHHHHOHOHOHOHHHHHHHOHHHHHHHHHOHHHOHHHOHOHOHHHHHHHHHOHOHOHOHHHHHOHHHOHHHOHOHHHOHOHOHHHOHHHHHHHOH
OOOHOOOOOOOHOHOHOOOOOHOOOHOOOOOOOHOOOOOOOHOHOOOHOOOOOHOOOHOHOOOHOHOOOHOOOHOHOHOOOHOHOHOHOHOOOOOHOHOH
OHOHHHHHHHHHOHOHHHHHHHOHHHOHHHHHOHHHHHHHOHOHHHOHOHHHOHOHHHOHHHOHOHOHHHOHHHOHOHHHOHOHOHOHOHHHOHOHOHOH
OHOOOHOOOOOOOHOOOOOOOHOHOOOHOOOHOOOOOHOOOHOOOHOHOHOOOHOHOOOOOHOHOHOHOHOHOOOOOOOHOHOOOHOOOHOHOHOOOHOH
HHHHOHHHOHHHHHHHHHHHOHOHOHHHOHOHHHHHOHOHHHOHOHOHOHHHHHOHOHHHHHOHOHOHOHOHHHHHHHOHOHHHHHHHOHOHOHHHHHOH
OOOHOHOOOHOOOOOOOHOOOHOOOHOOOHOOOOOHOHOHOOOHOHOOOHOOOOOHOHOOOOOHOOOOOHOOOOOOOHOHOOOHOOOHOOOHOOOHOOOH
OHOHOHOHHHOHHHOHOHOHHHOHHHOHHHHHHHOHOHOHHHOHHHHHOHOHHHHHOHOHHHHHHHHHOHHHHHHHOHOHHHOHOHOHHHOHHHOHOHHH
OHOOOHOOOOOHOHOHOHOHOHOOOHOHOOOOOOOHOHOOOHOHOOOOOHOHOOOOOHOHOOOOOOOHOHOOOOOHOHOOOHOHOHOOOOOHOOOHOOOH
OHHHHHOHHHHHOHOHHHOHOHHHOHOHHHHHOHHHOHHHOHOHOHHHHHOHOHHHHHOHOHHHHHOHHHOHHHOHOHHHHHOHOHHHHHHHOHHHHHOH
OOOHOOOHOOOOOHOOOOOHOOOOOHOOOOOHOHOOOHOOOHOHOHOOOOOHOHOOOOOOOHOOOOOOOOOHOOOHOHOOOHOHOOOHOOOHOOOOOHOH
OHOHOHHHHHOHHHHHHHHHOHHHHHHHHHOHOHOHHHOHHHOHOHOHHHHHOHOHHHHHHHHHHHHHHHHHHHOHOHOHOHOHHHOHOHOHHHOHHHOH
OHOHOHOOOHOOOOOOOHOOOOOHOOOOOHOHOHOOOHOHOOOHOHOOOOOHOHOHOOOOOOOOOHOOOOOOOHOOOHOHOOOHOHOHOHOOOHOOOOOH
OHOHOHOHOHHHHHOHOHHHHHOHOHHHOHOHOHOHOHOHHHOHOHHHHHOHHHOHOHHHHHHHOHOHHHHHOHHHHHOHHHHHOHOHOHHHOHHHHHHH
OHOHOOOHOOOHOOOHOOOOOHOHOOOHOOOHOHOHOHOOOOOHOOOHOHOOOOOHOOOHOOOHOOOHOOOHOHOOOOOHOOOOOHOHOOOHOOOOOOOH
OHOHHHHHHHOHOHHHHHHHOHHHHHOHHHHHOHHHOHOHHHHHHHOHOHHHHHHHHHOHOHOHHHHHOHHHOHOHHHHHHHOHOHOHHHOHHHHHHHOH
OHOOOHOOOHOOOHOHOOOHOOOHOOOHOOOOOOOHOHOHOOOOOOOHOOOHOOOHOOOHOHOOOOOOOOOHOHOOOHOOOHOHOHOOOOOHOOOOOHOH
OHHHOHOHHHHHHHOHOHOHHHOHOHHHHHHHHHOHOHOHOHHHHHHHOHOHHHOHOHHHHHHHHHHHHHOHOHHHOHOHOHOHOHHHHHHHOHHHOHOH
OOOHOHOOOOOOOHOOOHOOOHOHOHOOOOOHOOOOOHOHOOOHOOOOOHOHOOOHOOOHOOOOOOOOOHOOOOOHOOOHOHOHOOOOOHOOOHOOOHOH
HHHHOHHHHHOHHHOHHHHHOHOHOHOHHHOHHHHHHHHHHHOHHHOHHHOHOHHHHHOHOHHHHHHHOHHHHHOHHHHHOHOHHHHHOHOHHHOHHHOH
OOOHOHOOOOOHOOOHOOOHOOOHOOOHOOOHOOOOOOOOOHOOOHOHOHOOOHOOOHOOOOOHOOOHOHOOOHOOOHOOOHOOOHOOOHOOOHOHOOOH
OHOHOHOHHHOHOHHHOHHHHHHHOHHHOHHHOHHHHHHHOHHHOHOHOHOHHHOHOHHHHHOHOHHHOHOHOHHHOHOHHHHHOHHHHHOHHHOHOHHH
OHOOOHOOOHOHOHOOOHOOOOOOOHOHOOOOOOOOOOOHOHOOOOOHOOOHOOOHOOOHOOOHOOOHOOOHOOOHOHOHOOOOOHOOOHOHOOOHOHOH
OHHHHHOHOHHHOHHHOHOHHHHHHHOHHHHHHHHHHHOHOHOHHHHHHHHHOHHHHHOHOHHHOHOHHHHHHHOHOHOHOHOHHHOHOHOHOHOHOHOH
OOOOSHOHOOOHOOOHOOOOOOOHOOOOOOOHOOOOOHOHOHOHOOOOOHOOOHOOOHOHOHOOOHOHOOOOOOOHOOOHOHOOOOOHOOOHOHOHOOOH
HHHHGHOHHHOHHHOHOHHHHHOHOHHHHHOHOHHHOHHHOHOHOHHHOHOHHHOHOHOHOHHHHHOHOHHHHHHHHHHHOHHHHHHHHHHHOHHHHHOH
OOOHOHOHOOOHOOOHOHOOOHOHOHOOOHOHOHOHOOOHOOOHOHOHOHOHOOOHOOOHOOOOOHOHOOOHOOOOOHOOOHOOOOOOOOOHOOOOOHOH
OHOHHHOHOHOHOHHHHHOHOHOHHHOHOHOHOHOHHHOHOHHHOHOHOHOHHHHHOHHHHHHHOHOHHHOHHHHHOHOHHHOHHHHHHHOHHHHHOHOH
OHOHOOOHOHOHOHOOOOOHOHOHOOOHOOOHOHOHOOOHOHOOOHOHOHOHOOOHOOOHOOOHOHOOOHOOOOOHOOOHOHOOOHOOOOOOOOOHOOOH
HHOHOHHHOHHHOHOHHHHHOHOHOHHHOHHHOHOHOHHHOHOHHHOHOHOHOHOHHHOHHHOHOHOHHHHHHHOHOHHHOHHHOHOHHHHHHHOHHHHH
OOOHOHOHOHOOOHOOOHOHOHOOOHOOOHOOOHOOOHOOOHOOOHOOOHOOOHOOOHOOOHOOOOOHOOOOOOOHOHOOOHOOOHOHOOOOOHOHOOOH
OHOHOHOHOHOHHHHHOHOHOHHHHHHHHHOHHHOHHHHHHHOHOHHHOHHHOHHHOHHHOHHHHHHHOHHHHHHHOHOHHHOHHHOHOHHHHHOHHHOH
OHOHOHOHOHOOOOOHOHOOOHOOOOOHOOOHOHOHOOOOOHOHOOOHOOOHOOOHOHOHOOOOOOOHOHOOOHOOOHOHOOOHOOOHOOOOOHOOOOOH
OHHHOHOHOHHHHHOHOHOHHHOHHHOHOHHHOHOHOHHHOHOHHHOHHHOHHHOHOHOHHHHHHHOHOHHHOHOHHHOHOHHHOHHHHHHHOHHHHHOH
OOOHOOOHOOOOOOOHOHOHOOOHOOOOOHOOOHOOOHOOOHOHOOOHOOOHOOOHOHOHOOOHOOOHOOOHOHOHOHOOOHOHOHOOOOOOOHOOOHOH
HHOHHHOHHHHHHHHHOHOHHHOHHHHHHHHHOHHHHHOHHHOHOHHHOHHHHHOHOHOHOHOHOHHHHHOHOHOHOHOHHHOHOHHHOHOHHHOHOHOH
OOOHOOOHOOOOOOOHOHOOOHOOOHOOOOOHOHOOOOOHOOOHOHOHOHOOOHOHOHOOOHOOOHOOOOOHOOOHOOOHOOOHOHOOOHOHOOOHOOOH
OHOHOHHHOHHHHHOHOHHHOHHHOHHHOHOHOHOHHHHHHHHHOHOHOHOHOHHHOHHHOHHHHHOHHHHHOHHHOHHHHHOHOHOHHHHHOHHHHHHH
OHOHOOOHOHOOOHOOOHOOOHOOOHOOOHOOOHOHOOOOOOOOOHOHOOOHOOOHOOOHOOOOOOOHOHOOOHOOOOOOOOOHOHOOOOOOOOOHOOOH
OHOHHHOHOHOHOHHHHHOHHHOHHHOHHHHHHHOHHHHHOHHHHHOHHHHHHHOHHHOHHHHHHHHHOHOHHHHHHHHHHHHHOHOHHHHHHHOHOHOH
OHOOOHOHOHOHOOOOOHOOOOOHOOOOOHOOOHOHOOOOOHOOOOOOOOOOOHOOOOOHOOOOOHOOOOOHOOOOOOOHOOOOOHOHOOOOOHOOOHOH
OHHHOHOHOHHHHHOHHHHHHHHHOHHHOHOHOHOHOHHHHHOHHHOHOHHHHHHHHHOHOHHHOHOHHHHHOHHHHHOHOHHHHHHHOHHHOHHHHHHH
OHOOOHOOOHOOOOOHOOOOOOOOOHOHOOOHOOOHOHOOOOOHOHOHOHOOOHOOOHOHOHOHOHOOOOOHOHOOOHOOOHOOOOOOOHOHOOOOOOOH
OHHHHHHHHHOHHHHHOHHHHHHHHHOHHHHHHHHHOHOHHHHHOHOHHHOHOHOHOHOHOHOHOHHHHHOHOHOHOHOHHHOHHHHHHHOHHHHHHHOH
OOOOOOOOOHOOOOOOOHOOOOOHOHOOOOOHOOOOOHOOOHOOOHOHOOOHOOOHOOOHOOOHOOOHOOOHOHOHOOOHOOOHOOOHOOOHOOOOOOOH
OHHHOHHHOHOHHHHHHHHHOHOHOHOHOHHHOHOHHHHHOHOHOHOHOHHHHHHHHHOHHHOHHHOHHHOHOHOHHHHHOHHHOHOHHHOHOHHHHHOH
OHOHOHOOOHOOOHOOOOOOOHOOOHOHOHOOOHOHOOOOOHOHOHOHOHOHOOOOOHOOOHOHOHOOOHOOOHOHOOOOOHOOOHOOOOOHOHOOOOOH
OHOHOHOHHHHHOHOHHHOHHHOHHHOHOHOHHHOHHHHHOHHHOHOHOHOHOHHHOHHHHHOHOHHHOHOHHHHHOHHHHHHHOHHHHHOHOHOHHHHH
OOOHOHOHOHOOOHOOOHOHOOOHOOOHOOOHOOOHOOOHOOOOOHOOOOOHOOOHOOOOOOOOOHOOOHOHOOOOOHOOOOOOOHOOOHOHOHOHOOOH
OHHHOHOHOHOHHHHHOHOHOHHHOHHHHHHHOHHHOHOHHHHHHHHHHHHHHHOHHHHHHHHHHHOHHHOHOHHHHHOHOHHHHHHHOHOHOHHHOHOH
OHOOOHOOOHOOOHOHOHOHOHOOOHOOOOOHOHOOOHOOOOOOOOOOOOOOOHOOOHOOOHOOOHOHOOOHOOOHOHOHOOOOOOOHOHOHOOOHOHOH
OHOHHHOHHHHHOHOHOHOHHHOHHHHHOHOHOHOHHHHHHHHHHHHHHHOHHHHHOHOHHHOHOHOHOHHHHHOHOHOHHHHHHHOHOHOHHHOHOHOH
OHOHOOOHOOOHOHOHOHOOOHOHOOOOOHOHOOOHOOOOOOOOOOOOOHOOOOOOOHOHOOOHOOOHOHOHOOOHOOOHOOOOOOOHOOOOOHOOOHOH
HHOHOHHHOHOHOHOHOHHHOHOHOHHHHHOHHHHHOHHHHHHHHHOHOHHHHHHHHHOHOHHHHHHHOHOHOHHHHHHHOHOHHHHHHHHHHHHHOHOH
OOOHOOOHOHOOOHOOOHOHOOOHOHOOOHOOOOOHOOOOOHOOOOOHOHOOOOOOOHOHOOOHOOOOOOOHOOOOOOOOOHOHOOOHOOOOOOOHOHOH
OHHHHHHHOHHHHHOHHHOHHHHHOHOHOHHHHHOHHHHHHHOHHHHHOHOHHHHHOHOHHHOHHHHHHHOHHHHHHHHHOHHHOHOHOHHHHHOHHHOH
OOOHOOOHOHOOOOOHOOOOOOOOOHOHOHOOOHOOOOOOOOOHOOOHOHOHOOOHOOOHOHOOOOOHOOOHOHOOOOOOOHOOOHOOOHOOOHOOOHOH
OHOHOHOHOHOHHHHHOHHHHHHHOHOHOHOHOHHHHHHHHHHHHHOHOHOHOHHHHHOHOHHHHHOHOHHHOHOHHHHHHHOHHHHHHHOHHHHHOHOH
OHOOOHOOOHOOOOOHOHOOOOOHOHOHOHOHOHOOOOOHOOOOOOOHOOOHOHOOOOOHOOOOOHOHOOOOOHOOOOOHOHOHOOOOOHOOOOOHOHOH
OHHHHHHHHHHHHHOHOHOHHHOHHHOHOHOHHHOHOHOHHHHHOHOHHHHHOHOHHHHHHHHHOHOHHHHHHHHHHHOHOHOHHHHHOHOHOHHHOHOH
OHOOOOOOOOOOOHOOOHOHOOOOOHOHOHOOOOOHOHOHOOOHOHOOOOOHOOOHOOOOOOOOOHOOOOOOOOOOOOOOOHOOOOOHOOOHOOOHOOOH
OHHHOHOHHHHHOHHHHHOHHHHHOHOHOHHHHHOHOHOHOHOHOHHHHHOHOHHHHHOHOHHHOHHHHHHHHHHHHHHHHHHHHHOHOHHHHHOHHHOH
OOOHOHOOOOOHOHOOOHOOOOOHOOOHOOOOOHOHOHOOOHOOOHOOOOOHOOOOOHOHOHOOOHOOOOOHOOOHOOOHOOOOOHOHOHOOOHOOOHOH
HHOHHHOHHHOHOHOHOHOHHHOHHHHHHHHHOHOHOHHHHHHHOHHHHHHHHHHHOHOHOHOHHHOHHHOHOHOHOHOHOHHHOHOHOHOHOHOHHHOH
OHOOOHOHOHOHOHOHOHOHOOOHOOOOOOOOOHOHOOOOOOOHOHOOOOOOOOOHOHOHOHOOOHOOOHOOOHOHOHOOOHOOOOOHOHOHOHOHOOOH
OHHHOHOHOHOHOHOHOHHHOHHHOHHHHHHHHHHHOHHHHHOHHHOHHHHHHHOHOHHHOHHHOHHHOHHHHHHHOHOHHHHHHHHHOHOHOHOHOHHH
OOOHOHOOOHOHOOOHOOOOOHOHOHOOOOOHOOOHOOOOOHOOOHOHOOOOOHOHOHOOOHOHOOOHOOOOOOOHOHOHOOOOOOOHOHOHOHOHOHOH
OHHHOHHHOHOHHHHHHHHHHHOHOHOHHHOHOHOHHHOHHHHHOHOHHHOHOHOHOHOHHHOHHHOHHHOHHHOHOHHHOHHHHHOHOHOHOHOHOHOH
OOOHOOOHOHOHOOOHOOOOOOOHOHOOOHOOOHOOOHOHOOOHOHOOOHOHOHOOOOOHOOOOOHOOOHOHOOOHOOOOOOOHOOOHOHOHOHOOOHOH
HHOHHHOHHHOHOHOHHHOHHHOHOHOHOHHHHHHHOHHHOHOHOHHHOHHHOHHHHHHHOHHHOHHHOHOHOHOHHHHHHHHHOHHHHHOHOHOHHHOH
OOOOOHOOOOOHOHOOOOOHOOOHOHOHOHOOOOOHOHOOOHOHOOOHOOOOOHOOOOOHOHOHOHOOOHOHOHOHOOOOOHOOOHOOOHOHOHOOOOOH
OHHHOHHHHHHHOHHHOHHHHHHHOHHHOHOHOHOHOHOHHHOHOHOHHHHHOHOHHHOHOHOHOHOHHHHHOHOHHHOHHHOHHHOHOHOHOHHHHHHH
OHOOOHOOOOOOOHOHOHOOOOOHOOOOOHOHOHOHOHOHOHOHOHOOOOOHOHOOOHOHOOOHOOOOOOOOOHOHOOOHOOOHOOOHOOOHOOOHOOOH
OHHHHHOHOHHHHHOHOHOHHHOHHHHHHHOHOHOHOHOHOHOHOHHHOHHHOHHHOHOHHHHHHHHHHHHHHHOHOHHHOHHHOHHHHHHHHHOHOHOH
OOOOOOOHOOOOOHOOOHOHOOOOOHOOOOOHOHOHOOOHOHOHOOOHOOOOOHOOOHOOOOOOOOOHOOOOOOOHOOOHOHOOOHOOOOOOOHOOOHOH
OHHHHHHHHHHHOHOHHHOHOHHHOHOHHHHHOHHHHHHHOHOHHHHHOHHHHHOHHHHHHHHHHHOHOHHHHHHHHHOHOHOHHHOHHHHHOHOHHHOH
OOOOOHOOOHOOOHOOOHOHOOOHOHOOOHOHOOOOOOOOOHOOOOOHOOOHOOOHOOOOOOOOOHOHOHOOOOOOOOOHOOOHOOOHOOOHOHOHOOOH
HHHHOHHHOHOHHHHHHHOHHHOHHHHHOHOHHHOHHHHHOHHHHHOHHHOHOHHHOHHHOHOHHHOHOHOHOHHHHHOHHHHHOHHHOHOHOHHHOHHH
OOOHOOOOOHOOOOOHOOOHOHOOOOOOOHOOOHOOOOOHOHOOOOOHOOOHOHOOOOOHOHOHOOOHOHOHOOOOOHOOOHOOOHOOOHOHOOOHOOOH
OHHHHHHHOHHHHHOHOHHHOHHHHHHHHHOHHHHHHOOHOHOHHHHHHHHHOHOHHHHHOHOHOHHHOHHHOHHHOHHHHHOHHHOHHHOHHHOHOHOH
OOOOOHOOOHOOOHOHOOOHOOOOOOOOOOOHOOOOOOOHOHOHOOOOOHOOOHOHOOOOOHOHOHOOOOOHOHOOOHOOOHOHOHOHOOOOOHOHOHOH
OHHHOHOHHHHHOHOHHHOHHHOHHHHHOHOHOHHHHHHHOHOHOHHHOHOHHHOHOHHHHHOHOHHHHHOHHHOHOHOHOHOHOHOHOHHHOHOHOHOH
OHOOOHOOOOOOOHOOOHOOOHOOOHOOOHOHOOOHOOOOOHOHOHOHOOOHOOOHOHOOOOOHOOOOOHOOOOOHOHOHOOOHOOOHOHOHOHOHOHOH
HHOHOHHHHHOHHHOHHHHHOHHHOHOHHHOHHHOHHHHHHHOHOHOHHHHHHHOHOHHHHHHHHHHHOHHHHHHHHHOHHHHHOHHHOHOHOHOHHHOH
OOOHOHOOOOOHOOOHOOOOOHOOOHOOOHOHOHOHOOOOOOOHOHOOOOOOOHOHOHOOOHOOOOOHOOOOOOOHOOOHOOOOOHOOOHOOOHOOOHOH
OHHHHHOHHHHHOHHHOHHHHHOHHHHHOHOHOHOHOHHHHHHHOHOHHHOHOHHHOHOHOHOHOHOHHHHHHHOHOHHHHHHHHHOHHHHHHHHHOHOH
OOOHOOOHOOOHOOOHOHOOOOOHOOOHOHOOOHOOOHOOOOOOOHOHOOOHOOOOOHOHOOOHOHOOOOOOOHOHOOOOOHOOOOOHOOOOOOOHOHOH
HHOHOHHHOHOHHHOHOHOHHHHHHHOHOHHHOHHHHHOHHHHHOHHHOHHHHHHHOHOHHHHHOHHHOHHHHHOHHHHHOHOHHHHHOHHHHHOHOHOH
OOOHOOOHOHOHOHOOOHOOOHOOOOOHOHOOOHOOOOOHOOOHOOOHOHOOOOOOOHOOOHOOOHOOOHOOOHOHOOOOOHOHOOOOOHOOOHOOOHOH
OHHHHHOHOHOHOHHHHHHHOHOHHHHHOHOHHHHHOHHHOHOHHHOHOHHHOHHHHHHHOHOHOHHHHHOHOHOHOHHHHHOHOHHHHHOHOHHHHHOH
OOOOOHOOOHOHOOOOOOOHOHOOOOOHOHOOOOOHOOOOOHOOOHOHOOOHOHOHOOOOOHOHOHOOOOOHOOOHOHOOOHOOOHOOOOOHOHOOOOOH
HHOHHHHHHHOHOHHHOHOHOHHHHHOHOHHHHHOHHHHHHHHHOHOHHHOHOHOHOHHHHHOHOHOHHHHHHHHHOHHHOHOHHHHHOHHHOHOHHHHH
OOOHOOOOOOOHOHOOOHOHOOOOOOOHOHOOOHOOOOOHOOOOOHOOOHOHOOOHOHOOOHOHOHOHOOOOOOOHOOOHOOOHOOOHOOOHOHOOOOOH
OHHHOHHHHHHHHHOHHHOHHHHHHHHHOHOHHHHHHHOHOHHHHHHHOHOHHHHHOHHHOHOHOHOHOHOHHHOHHHOHOHHHOHOHHHOHOHHHHHOH
OOOHOOOHOOOOOHOHOHOOOOOOOHOOOHOOOOOOOHOHOOOHOOOHOHOOOOOOOHOOOHOHOHOHOHOOOHOHOOOHOHOOOHOHOOOHOOOOOHOH
OHOHHHOHOHHHOHOHOHHHHHHHOHOHHHOHHHOHHHOHHHHHOHOHOHOHHHHHHHOHOHOHHHOHHHHHOHOHOHHHOHOHHHOHOHHHHHHHOHOH
OHOOOOOOOHOOOOOHOOOOOOOOOOOHOOOOOHOOOOOOOOOOOHOOOHOOOOOOOOOHOHOOOOOOOOOOOHOOOHOOOOOHOOOOOHOOOOOOOOOH
HHHHHHHHHHHHHHHHHHHHHHHHHHHHHHHHHHHHHHHHHHHHHHHHHHHHHHHHHHHHHHHHHHHHHHHHHHHHHHHHHHHHHHHHHHHHHHHHHHHH
