OOOHOOOHOOOHOOOHOOOOOHOOOOOOOOOHOOOOOOOOOHOOOHOOOOOOOHOOOOOOOHOOOOOOOOOHOOOOOOOOOOOOOOOOOOOOOOOOOHOH
OHOHOHOHHHOHOHOHOHOHHHOHHHHHOHHHOHOHHHHHOHOHOHOHHHHHHHOHHHHHOHOHHHOHHHOHOHHHOHOHHHHHHHHHHHHHHHHHOHOH
OHOOOHOOOOOHOHOHOHOOOOOHOOOHOOOOOHOHOOOOOHOHOHOOOHOOOOOHOOOHOOOHOOOHOOOHOHOHOHOHOOOOOOOHOOOOOOOHOHOH
OHHHHHHHOHHHOHOHOHHHHHHHOHOHHHHHHHOHOHHHHHOHOHHHOHOHHHHHOHOHOHHHOHHHHHHHOHOHOHHHOHHHHHOHOHHHOHHHOHOH
OOOHOOOOOHOOOHOOOHOHOOOOOHOOOHOOOOOHOOOHOOOHOOOHOOOHOOOOOHOHOOOHOHOOOOOOOOOHOOOOOOOOOHOHOOOHOOOOOHOH
OHOHOHHHHHOHHHHHHHOHOHHHHHOHHHOHHHOHHHHHOHHHHHOHOHHHOHHHHHOHHHHHOHOHHHHHHHOHHHHHHHHHHHOHHHOHHHHHHHOH
OHOHOHOOOOOHOOOOOOOHOHOOOHOOOHOHOOOHOOOOOHOOOOOHOHOOOHOOOHOOOOOHOOOHOOOOOHOHOOOHOOOOOHOHOHOHOOOOOHOH
OHOHHHOHHHHHHHOHHHOHOHOHOHHHOHOHHHHHOHHHHHOHHHHHOHOHHHOHHHHHHHOHHHOHOHHHOHHHOHOHOHHHOHOHOHOHHHOHOHOH
OHOOOHOHOOOOOHOOOHOOOHOHOOOHOHOHOOOOOOOHOOOHOOOOOHOHOOOOOOOOOHOOOHOHOOOHOOOOOHOOOHOHOOOHOHOOOOOHOHOH
OHHHOHOHOHHHOHHHHHHHOHOHHHHHOHOHOHHHHHHHOHHHHHHHHHOHHHOHHHOHHHHHOHHHHHOHHHHHHHHHHHOHHHHHOHHHHHHHOHOH
OHOOOHOHOHOOOHOOOOOHOOOHOOOHOHOOOHOOOOOOOHOOOOOOOHOOOHOOOHOOOOOHOOOOOOOHOOOOOOOOOHOHOOOOOOOOOOOHOHOH
OHOHHHOHOHOHHHOHHHOHHHHHOHOHOHHHHHOHHHHHHHHHOHHHOHHHOHHHHHHHOHHHHHHHHHHHHHHHHHOHOHOHOHHHHHHHHHOHOHOH
OHOOOHOHOHOOOOOHOOOHOOOHOHOOOOOOOHOOOOOOOHOOOHOOOOOOOHOOOOOHOHOOOOOOOOOOOOOOOHOHOOOHOOOOOOOHOOOHOHOH
OHHHOHOHOHHHHHHHOHHHOHOHOHHHHHHHOHHHHHHHOHOHHHHHHHHHOHOHHHOHOHOHHHHHHHHHOHHHOHOHOHHHHHHHHHOHOHHHOHOH
OOOHOHOOOHOOOHOOOOOOOHOOOHOOOOOHOOOHOOOHOHOOOHOOOHOOOHOHOOOHOHOHOOOHOOOOOHOHOHOHOHOOOOOHOOOHOOOOOHOH
HHHHOHHHHHOHHHOHHHHHHHHHOHOHHHOHHHHHOHOHOHHHOHOHOHHHHHOHOHHHOHOHOHOHOHHHHHOHOHOHHHOHHHOHOHHHHHHHHHOH
OOOHOOOOOOOHOOOHOHOOOHOOOHOOOHOOOOOOOHOHOOOHOOOHOOOOOOOHOOOHOOOHOHOOOHOHOOOOOOOHOOOHOOOHOHOHOOOOOHOH
OHOHHHOHHHOHOHHHOHOHOHHHOHHHOHHHHHHHHHOHOHOHOHHHHHOHHHHHHHOHHHHHOHHHHHOHOHHHHHHHOHHHOHOHOHOHOHOHOHOH
OHOOOOOHOOOHOHOOOHOHOOOHOOOHOHOOOOOOOHOHOHOHOHOOOHOOOHOOOHOOOHOOOHOOOHOOOOOHOOOHOOOHOHOHOHOOOHOHOOOH
OHHHHHOHHHHHOHOHHHOHHHOHHHHHOHOHHHHHOHOHOHOHOHOHOHOHHHOHOHHHOHOHOHOHOHHHHHHHOHOHHHOHOHOHOHHHHHOHHHOH
OOOHOHOHOOOOOOOHOOOHOOOHOOOOOHOOOHOOOHOHOHOHOHOHOHOHOOOHOOOOOHOHOHOHOHOOOOOHOHOHOOOHOHOHOOOOOOOHOOOH
OHOHOHOHOHHHHHHHOHHHOHHHOHHHHHHHOHHHHHOHOHOHHHOHOHHHOHHHHHHHHHOHHHOHOHOHHHOHOHOHOHHHOHHHHHHHHHHHOHHH
OHOHOOOHOOOHOHOOOHOOOOOOOHOOOOOOOHOOOOOHOHOOOOOHOOOHOHOOOOOHOOOHOOOHOOOHOHOOOHOHOHOHOOOOOOOOOHOOOHOH
OHOHHHHHHHOHOHOHHHHHHHHHHHHHHHOHOHOHHHHHOHHHHHHHHHOHOHOHOHHHOHOHOHHHHHHHOHHHHHOHOHOHHHHHHHHHOHOHHHOH
OHOOOOOOOHOHOHOOOOSHOOOOOOOOOOOHOHOHOOOOOOOHOOOOOOOHOHOHOHOOOHOHOHOHOOOOOOOHOOOHOHOOOHOOOHOOOHOHOOOH
OHHHHHOHOHOHOHHHHHOHOHOHHHHHHHHHOHOHHHHHHHHHOHHHHHHHOHOHOHOHHHOHOHOHOHOHHHOHOHOHOHOHOHOHOHOHHHOHOHOH
OOOHOHOHOHOHOOOOOHGHOHOHOHOOOOOHOHOOOOOOOOOOOHOOOOOOOHOHOHOHOHOHOHOHOHOHOOOHOHOHOOOHOHOHOHOOOOOHOHOH
HHOHOHOHHHOHOHHHOHHHHHOHOHOHOHHHOHHHHHHHHHHHHHOHHHHHHHOHOHOHOHOHOHOHOHOHOHHHOHOHHHHHOHOHHHHHHHHHOHOH
OOOHOHOOOOOHOOOHOHOOOOOHOOOHOOOOOHOOOHOOOOOOOOOHOOOOOHOHOHOOOHOOOHOOOHOHOHOOOHOHOOOHOHOOOOOOOHOOOHOH
OHHHOHHHHHHHHHOHOHHHOHHHOHHHHHHHHHOHHHOHOHOHHHHHOHHHOHOHHHHHOHHHHHOHHHOHOHOHHHHHOHOHOHHHOHOHHHOHHHOH
OHOOOHOOOOOOOOOHOOOOOHOHOHOOOOOHOOOHOOOHOHOHOOOOOOOHOHOOOOOOOHOOOOOHOOOHOHOOOOOOOHOHOOOHOHOOOHOHOOOH
OHOHOHHHOHOHHHHHHHHHHHOHOHOHHHOHOHOHOHHHOHOHOHHHHHHHOHOHHHHHHHOHHHHHOHHHOHHHHHHHHHOHHHOHOHHHOHOHOHHH
OOOHOOOHOHOOOHOHOOOOOOOOOHOHOOOOOHOHOHOHOHOHOHOOOHOOOHOHOOOOOOOOOHOOOHOHOHOOOOOOOHOOOOOHOOOHOOOHOOOH
HHHHHHOHHHHHOHOHOHHHHHHHHHOHHHHHHHHHOHOHOHHHOHOHHHOHHHOHHHHHOHHHHHOHHHOHOHOHOHOHHHHHHHHHOHHHHHOHHHOH
OOOOOHOOOOOOOHOOOHOOOOOOOHOHOOOOOOOOOHOHOOOOOHOHOOOHOHOOOOOHOHOOOOOHOOOHOHOHOHOHOOOHOOOOOHOOOHOHOOOH
OHOHOHHHHHHHHHOHHHHHOHHHOHOHOHHHHHHHHHOHHHHHHHOHOHHHOHHHHHOHHHOHHHHHOHOHOHHHOHHHOHOHOHHHHHOHOHHHOHHH
OHOHOOOOOOOHOHOOOOOHOHOHOHOOOHOOOOOOOHOOOOOOOOOHOOOHOOOOOHOOOOOHOOOOOHOHOOOHOOOOOHOOOOOHOOOHOOOHOOOH
OHOHHHHHHHOHOHHHHHOHOHOHOHOHHHHHHHOHOHOHHHHHHHHHHHOHOHHHHHHHHHHHOHHHHHOHHHOHHHHHHHHHHHOHOHHHHHOHOHOH
OHOHOOOHOOOOOHOOOOOHOHOOOHOHOOOOOOOHOOOHOOOOOOOHOOOHOOOOOOOOOHOOOHOOOHOOOHOOOOOOOOOHOOOHOHOOOHOHOHOH
HHOHOHOHOHHHHHOHHHHHOHOHHHOHHHOHHHHHHHOHOHHHHHOHOHHHOHHHOHHHHHOHHHOHOHOHOHHHHHHHHHOHOHHHOHOHHHOHHHOH
OOOHOHOOOHOOOOOHOHOOOHOHOHOOOHOHOOOHOOOHOOOOOHOHOHOOOOOHOHOOOOOHOHOHOHOHOOOHOOOOOHOHOOOHOHOOOHOOOHOH
OHOHHHHHOHOHHHHHOHOHOHOHOHHHOHOHOHOHHHHHHHHHOHOHOHHHHHOHOHOHHHHHOHOHOHOHHHOHOHHHOHOHOHHHOHOHOHHHOHOH
OHOHOOOHOHOOOOOHOOOHOHOHOOOHOOOHOHOHOOOOOHOOOHOHOOOOOHOHOHOHOOOOOHOHOHOHOOOHOHOOOHOHOHOOOHOHOHOOOHOH
OHOHOHOHHHHHHHOHHHHHOHOHHHOHOHHHOHOHOHHHOHOHHHOHHHHHOHOHOHOHHHHHOHOHOHOHOHHHOHOHHHOHOHOHHHHHOHOHHHOH
OHOHOHOOOOOOOHOOOOOOOHOOOHOOOHOOOHOOOHOHOOOHOHOOOHOOOHOHOOOHOOOOOHOHOOOHOHOOOHOOOHOHOHOOOOOHOOOOOHOH
OHHHOHHHHHHHOHHHHHHHHHHHOHOHHHOHHHHHHHOHHHHHOHHHOHOHHHOHHHHHOHHHOHOHHHHHOHOHHHHHOHOHHHHHHHOHHHHHOHOH
OOOOOHOHOOOOOHOOOOOOOOOHOHOHOOOHOOOOOHOOOOOOOOOHOOOHOHOHOOOHOHOOOHOOOOOHOOOHOOOHOHOHOOOOOOOHOOOHOOOH
OHHHHHOHOHHHHHOHHHHHOHOHOHHHOHHHOHOHOHOHHHOHHHOHHHHHOHOHOHOHOHOHHHHHHHOHHHOHOHOHOHOHOHHHHHHHOHOHHHOH
OOOOOOOHOOOOOOOHOOOHOHOHOOOOOHOHOHOHOHOOOHOHOHOHOOOOOHOOOHOOOHOOOOOOOHOHOOOHOHOHOHOHOOOOOOOOOHOOOHOH
HHHHHHOHHHHHHHHHHHOHOHOHHHHHHHOHOHOHHHHHOHOHOHOHHHHHOHHHHHOHHHHHHHHHOHOHHHOHOHOHHHOHHHOHHHHHHHHHOHOH
OOOOOHOOOHOOOHOOOOOHOHOHOOOOOOOHOHOOOHOOOHOHOOOOOOOOOHOOOOOHOOOOOOOHOHOOOHOHOHOOOHOOOHOHOOOOOOOOOHOH
OHHHHHHHOHOHOHOHHHOHOHHHOHOHHHHHOHHHOHOHHHOHHHHHHHHHHHOHHHHHOHHHHHOHHHHHOHHHOHHHOHHHOHHHOHHHOHHHHHOH
OHOOOOOHOHOHOOOHOOOHOOOOOHOHOOOOOHOHOHOHOHOOOHOOOOOOOOOHOOOHOHOOOHOOOOOOOHOOOHOHOOOHOHOOOHOOOHOOOHOH
OHOHOHOHOHOHHHHHOHHHHHHHHHOHOHHHHHOHOHOHOHHHOHOHHHHHHHHHHHOHOHOHHHHHHHHHOHOHHHOHOHHHOHOHHHHHHHOHOHOH
OOOHOHOHOOOHOHOOOHOHOOOOOHOOOHOOOOOHOOOHOHOOOHOOOHOOOOOOOOOHOHOOOHOOOOOHOHOHOOOHOOOOOHOOOOOOOOOHOHOH
OHHHOHOHHHHHOHOHHHOHOHOHHHHHHHOHHHHHHHOHOHOHHHHHOHHHHHOHOHOHOHHHOHOHHHOHOHOHHHOHHHHHHHHHOHHHHHHHOHOH
OHOHOHOHOOOHOOOHOOOHOHOOOOOOOOOHOOOOOHOOOHOOOOOHOOOOOHOHOHOHOOOHOHOHOOOHOHOOOHOOOOOOOOOHOOOHOOOOOHOH
OHOHOHHHOHOHOHHHHHOHOHHHHHHHHHOHOHHHOHHHOHHHHHOHHHHHOHHHOHOHHHOHOHOHOHHHOHHHOHHHOHHHHHOHHHHHOHHHHHOH
OHOHOOOOOHOOOHOOOOOHOHOOOOOHOOOHOOOHOOOHOHOOOOOOOOOHOHOOOHOHOHOHOOOHOHOOOHOHOOOHOHOOOHOHOOOOOHOHOOOH
OHOHHHHHHHHHHHHHOHHHOHOHHHOHOHHHHHOHHHOHHHOHHHOHHHHHOHOHHHOHOHOHHHOHOHOHHHOHHHOHOHOHOHOHOHHHHHOHOHHH
OOOOOHOHOOOOOOOHOOOOOHOOOHOHOOOOOHOHOOOOOOOHOOOHOOOHOOOHOOOOOHOOOHOHOOOHOOOOOHOOOHOHOHOHOHOOOOOHOHOH
HHHHOHOHOHHHOHOHHHOHHHHHHHOHHHHHOHOHHHHHOHHHHHHHOHOHHHHHOHHHHHHHOHOHHHHHOHHHOHHHHHOHHHOHOHHHOHHHOHOH
OOOOOHOOOHOOOHOOOHOOOOOHOOOHOOOOOHOOOOOHOHOOOOOOOHOOOHOOOHOHOOOOOHOOOOOOOHOOOOOOOOOHOOOHOOOHOOOHOOOH
OHHHHHHHHHOHHHHHOHHHHHOHOHOHOHHHHHHHHHOHOHOHHHHHHHHHOHOHHHOHOHHHHHOHHHHHHHHHHHHHHHOHOHHHHHOHOHOHHHOH
OOOOOOOOOHOOOHOOOHOOOOOOOHOHOHOOOOOOOHOHOHOOOOOHOOOHOHOHOOOHOHOOOHOHOOOOOOOHOOOOOOOHOOOOOOOHOHOHOOOH
HHOHHHHHOHHHOHOHHHHHHHHHHHHHOHOHOHHHHHOHOHHHHHOHHHOHOHOHHHOHOHOHOHHHOHHHHHOHHHHHHHHHHHHHHHHHHHOHOHHH
OOOHOOOHOOOOOHOOOHOOOOOOOOOHOOOHOOOHOOOHOOOOOHOOOHOHOHOOOOOHOOOHOHOOOHOHOOOHOOOOOOOOOOOOOHOOOOOHOOOH
OHHHOHOHHHHHHHHHOHOHHHHHHHOHOHHHHHOHOHHHHHHHOHHHOHOHOHHHHHOHHHHHOHOHHHOHOHOHOHHHHHHHOHHHOHOHOHHHHHOH
OHOOOHOOOOOHOOOHOHOHOOOHOOOHOHOOOOOHOHOOOOOHOOOHOOOHOHOOOHOOOHOHOOOOOOOHOHOHOHOOOOOHOHOHOHOHOOOOOOOH
HHOHHHHHHHOHHHOHOHOHOHHHOHHHHHOHHHOHOHHHOHHHHHOHHHOHOHOHOHHHOHOHHHHHHHOHOHHHOHOHHHOHOHOHOHOHHHHHHHHH
OOOHOOOOOHOHOOOHOOOHOHOOOOOOOOOHOOOHOOOHOOOHOOOOOHOHOOOHOOOHOHOHOOOOOHOHOOOHOHOOOHOHOHOOOHOOOHOOOOOH
OHHHOHHHOHOHOHHHHHHHOHOHHHHHHHHHHHHHHHOHOHOHOHHHHHOHHHHHHHOHOHOHOHHHOHHHHHOHOHHHHHOHOHOHHHHHOHHHHHOH
OHOOOOOHOHOHOOOOOOOOOHOHOHOOOOOOOOOHOOOHOHOHOHOOOOOHOOOOOHOOOOOHOHOOOOOOOHOOOOOOOOOHOHOOOOOHOOOOOOOH
OHHHHHHHOHOHHHHHHHOHOHOHOHOHHHHHHHOHOHHHOHOHOHOHHHHHHHHHOHHHHHHHOHHHHHHHOHHHHHHHHHOHOHHHHHOHHHHHHHOH
OHOOOHOOOHOHOOOOOHOHOOOOOHOHOOOOOHOOOHOHOHOOOHOOOOOOOOOHOHOOOOOHOHOOOHOOOOOOOOOHOOOHOOOOOHOOOHOOOOOH
OHOHOHOHHHOHOHHHOHOHHHHHHHOHOHHHOHHHHHOHOHHHHHHHHHHHHHOHOHOHHHOHOHOHOHHHHHHHHHOHHHHHHHHHOHHHOHOHHHHH
OOOHOHOOOHOOOHOHOHOOOHOOOOOHOOOHOOOOOOOHOHOOOOOOOOOHOOOHOHOHOOOOOHOHOOOOOOOHOHOOOHOOOOOOOHOHOHOOOOOH
OHHHOHOHOHHHHHOHOHHHHHOHHHOHHHHHOHHHOHHHOHHHOHHHHHHHOHHHOHOHHHHHOHOHHHHHHHOHOHHHOHOHHHHHHHOHOHHHHHOH
OHOHOHOHOOOOOHOOOHOOOOOHOOOHOOOHOHOHOOOOOOOHOOOOOOOHOOOHOHOHOOOHOHOHOOOHOOOHOOOOOHOHOOOHOOOOOHOOOOOH
OHOHOHOHHHOHHHOHHHOHHHHHOHHHOHOHOHOHHHHHHHOHHHHHHHOHHHOHOHOHOHOHHHOHOHOHOHHHHHHHOHOHOHOHOHHHHHOHHHHH
OOOHOHOOOHOOOOOOOOOHOOOOOHOOOHOHOOOOOHOOOHOOOHOOOOOOOHOHOHOOOHOOOHOHOHOHOOOHOOOHOOOHOHOHOHOOOHOOOOOH
HHHHOHHHHHHHOHHHHHHHHHHHHHOHHHOHOHHHHHOHOHHHOHOHHHHHHHOHOHHHHHHHOHOHHHOHHHOHOHOHHHHHOHOHOHHHOHHHHHOH
OOOOOHOOOOOHOOOHOOOOOOOOOOOHOOOHOHOOOOOHOHOOOOOHOOOOOHOOOHOOOHOOOHOOOHOOOHOOOHOOOOOOOHOHOHOOOOOHOOOH
OHHHOHOHHHOHHHOHOHHHHHHHHHHHOHHHHHOHHHHHOHOHHHHHOHHHOHHHOHHHOHOHOHHHOHOHHHHHHHHHHHHHHHOHOHOHHHHHOHHH
OOOHOHOOOHOHOHOHOHOOOOOHOOOHOHOOOOOOOOOHOHOHOOOOOHOHOOOHOOOHOHOHOHOOOHOOOOOHOOOOOOOHOOOHOHOHOOOOOHOH
HHOHHHOHHHOHOHOHOHHHOHOHOHOHOHOHHHHHHHHHOHOHOHHHHHOHOHOHHHOHOHOHHHOHHHOHOHHHOHHHHHOHOHHHOHOHOHHHHHOH
OOOHOOOHOOOHOOOHOOOOOHOOOHOHOOOHOOOHOOOOOHOHOHOOOOOHOHOOOHOHOHOOOOOHOOOHOOOHOOOHOHOHOHOOOOOHOHOOOOOH
OHOHOHHHOHHHHHHHHHHHHHHHHHOHHHHHOHHHOHHHHHOHOHHHHHOHOHHHHHOHOHHHHHHHOHHHHHOHHHOHOHOHOHHHHHHHOHOHHHOH
OHOHOHOHOOOOOOOOOHOOOOOHOOOHOOOOOOOHOHOOOHOHOOOOOOOHOHOOOHOHOHOOOHOOOHOOOHOOOHOOOHOHOOOOOOOHOHOOOHOH
OHHHOHOHHHHHHHOHOHOHHHHHOHHHOHHHHHOHOHOHOHHHHHHHHHOHOHOHOHOHOHOHOHOHHHOHOHOHOHHHOHOHHHHHHHOHOHOHHHOH
OOOHOHOOOOOOOHOHOOOHOOOOOHOHOHOHOOOHOOOHOHOOOOOHOOOHOOOHOOOHOOOHOOOOOHOHOHOHOOOHOHOOOOOOOHOHOHOHOOOH
OHOHOHOHHHOHOHOHHHOHOHHHHHOHOHOHOHHHHHHHOHOHHHOHOHHHHHHHHHHHHHHHHHHHHHOHOHHHOHOHOHOHHHHHOHOHOHHHOHOH
OHOHOHOOOHOHOHOHOOOHOHOOOHOOOOOHOOOOOHOHOHOOOHOOOHOOOOOHOOOOOOOOOOOOOOOHOHOOOHOHOHOOOHOOOHOHOHOOOHOH
OHOHOHHHHHOHOHOHOHHHOHHHOHOHHHHHHHOHOHOHOHHHOHHHHHOHHHOHOHOHHHHHHHHHHHHHOHOHHHHHOHHHOHOHHHOHOHOHHHOH
OHOOOHOOOOOHOHOHOOOHOOOHOHOHOOOHOOOHOOOHOOOOOHOOOHOHOHOOOHOHOOOOOHOOOHOOOHOOOOOOOOOHOHOOOHOHOHOHOOOH
OHHHHHOHHHHHOHOHHHHHHHOHOHOHOHOHOHHHHHOHHHHHHHOHHHOHOHHHHHOHOHHHHHOHOHOHHHOHHHHHHHOHOHHHOHOHOHOHOHHH
OHOOOOOHOOOOOHOOOHOOOHOHOOOHOHOHOHOOOHOOOHOOOOOOOOOOOHOOOOOHOOOHOOOHOHOHOOOHOOOHOOOHOHOOOHOHOOOHOHOH
OHHHHHOHOHHHHHHHOHOHOHOHHHHHOHOHOHOHHHHHOHHHHHHHHHHHHHOHHHHHOHOHOHHHOHOHHHHHOHOHHHHHOHOHHHOHHHHHOHOH
OOOOOOOHOOOOOOOHOOOHOOOOOOOOOHOOOHOOOOOOOOOOOOOOOOOOOOOHOOOOOHOOOOOHOOOOOOOOOHOOOOOOOHOOOHOOOOOOOOOH
HHHHHHHHHHHHHHHHHHHHHHHHHHHHHHHHHHHHHHHHHHHHHHHHHHHHHHHHHHHHHHHHHHHHHHHHHHHHHHHHHHHHHHHHHHHHHHHHHHHH
