OHOOOOOOOHOOOHOOOOOHOOOHOOOOOOOHOOOHOOOOOOOHOOOOOOOOOHOOOOOOOOOOOHOOOHOOOOOHOOOOOOOOOHOOOOOOOOOOOOOH
OHOHHHOHOHOHOHOHOHOHOHOHHHHHOHOHHHOHOHHHOHHHOHOHHHHHOHHHHHHHOHHHOHOHOHOHOHHHOHHHOHHHHHOHHHHHOHHHHHOH
OHOHOHOHOOOHOHOHOHOOOHOOOOOOOHOOOHOOOOOHOHOOOHOOOOOHOOOOOOOOOHOOOHOHOOOHOHOOOHOHOHOOOOOOOOOHOOOHOOOH
OHOHOHOHHHHHHHOHOHOHHHHHHHOHHHHHOHOHHHHHOHOHHHHHHHOHHHHHHHHHHHOHHHHHHHHHOHOHHHOHOHOHHHHHHHHHHHOHOHHH
OOOOOHOOOOOOOOOHOHOHOOOHOOOHOOOHOHOHOOOOOHOHOOOOOHOOOHOOOOOHOOOHOOOOOOOHOHOHOOOHOOOOOHOOOOOHOOOHOOOH
HHHHHHOHHHHHHHHHOHHHOHOHHHOHOHOHOHHHOHHHHHOHHHHHOHHHOHOHHHHHOHHHOHHHHHOHOHOHHHOHHHHHOHOHHHOHOHHHHHHH
OOOOOHOHOOOOOOOHOOOHOHOOOHOHOHOHOOOOOHOOOOOHOOOOOOOHOHOOOOOOOHOOOOOHOHOHOHOOOHOHOOOHOHOOOHOHOOOOOOOH
OHHHOHHHOHHHHHOHOHOHOHHHOHHHOHOHHHHHHHOHHHHHOHHHHHHHOHHHHHHHOHHHHHOHOHOHOHHHOHOHOHOHOHHHOHOHHHHHHHOH
OHOOOOOHOHOOOOOHOHOHOHOHOOOOOHOHOOOOOHOOOHOOOHOOOOOHOOOHOOOHOOOHOOOHOOOOOOOHOOOHOHOHOHOOOHOOOOOOOHOH
OHHHHHOHOHOHHHHHHHOHOHOHHHHHHHOHOHHHOHHHOHOHOHOHHHOHHHOHOHOHHHOHOHHHHHOHHHHHOHHHOHOHHHOHHHHHHHHHOHOH
OHOOOHOOOHOHOOOOOHOOOHOOOOOOOHOHOHOHOOOOOHOHOHOOOHOOOOOHOHOOOHOOOHOOOHOHOOOOOHOOOHOOOOOHOOOOOOOHOOOH
OHOHOHHHHHOHOHHHOHOHHHHHHHOHHHOHOHOHHHHHHHOHOHHHOHHHOHHHOHHHOHOHHHOHOHOHOHHHHHOHHHHHHHHHOHHHHHOHHHOH
OOOHOHOOOOOOOHOHOHOOOOOOOOOHOOOHOHOOOOOOOHOHOOOHOOOHOHOOOOOHOHOHOOOHOHOHOOOOOHOOOOOOOHOOOOOOOHOOOHOH
OHHHOHHHHHHHHHOHOHHHHHHHOHHHOHOHOHHHOHHHOHOHOHHHHHOHHHOHHHHHOHHHOHHHOHHHHHOHHHHHHHHHOHOHHHHHOHHHOHOH
OOOHOOOOOOOHOOOOOOOOOHOOOHOOOHOHOOOOOHOHOHOHOOOOOHOOOHOHOHOOOHOOOHOOOHOOOOOHOOOOOOOOOHOOOOOHOHOOOHOH
HHOHHHHHHHOHHHHHHHHHOHHHHHOHHHOHHHHHHHOHOHHHHHOHOHHHOHOHOHOHHHOHHHOHHHOHHHHHOHHHHHHHHHHHHHOHOHHHHHOH
OHOOOHOOOHOOOOOHOOOOOOOOOOOHOHOHOOOOOOOHOOOOOHOHOOOHOOOHOHOOOHOHOHOOOHOHOOOHOOOHOOOOOOOOOHOHOOOOOOOH
OHHHOHHHOHHHHHOHHHHHHHHHHHHHOHOHOHHHOHHHHHHHOHHHOHOHHHHHOHHHOHOHOHHHOHOHOHOHHHOHHHHHHHOHOHOHHHHHHHHH
OOOOOHOOOHOOOHOOOOOHOOOHOOOOOOOHOHOHOHOOOOOHOOOHOHOOOOOHOHOOOHOHOOOHOOOHOHOOOHOHOOOHOOOHOHOHOOOOOOOH
OHHHHHOHOHHHOHHHHHOHOHHHOHHHHHHHOHOHOHOHOHHHHHOHHHHHOHOHOHOHHHOHOHHHHHHHOHHHOHOHOHOHOHHHOHOHOHHHHHOH
OOOOOOOHOOOHOOOOOHOHOOOOOOOHOOOOOOOHOHOHOOOHOOOHOOOOOHOOOHOHOOOHOOOOOHOOOHOHOHOOOHOHOHOOOHOOOHOOOOOH
HHHHHHHHHHOHHHHHOHOHHHHHHHOHOHHHHHHHOHOHHHOHOHHHOHHHHHHHOHOHOHHHHHOHOHOHHHOHOHHHHHOHOHOHHHHHHHOHHHHH
OOOHOOOOOOOOOOOOOHOHOOOHOOOHOHOOOOOHOHOHOHOOOHOOOOOOOHOHOHOHOOOHOOOHOHOHOOOHOOOHOHOHOHOOOOOHOOOHOOOH
OHHHOHHHHHHHHHHHOHOHOHOHHHHHOHOHHHOHOHOHOHHHHHOHHHHHOHOHOHOHHHOHOHHHOHOHOHHHHHOHOHOHOHHHHHHHOHHHOHOH
OOOHOOOOOHOOOOOHOHOOOHOOOOOOOHOHOOOOOHOOOOOHOOOOOOOHOHOOOHOOOOOHOOOHOOOHOOOOOHOOOHOHOHOOOOOHOHOOOHOH
OHOHHHOHHHOHHHOHHHHHOHHHHHHHHHOHHHHHHHHHHHOHHHHHHHHHOHOHHHHHHHHHOHOHHHHHOHHHOHOHHHOHOHOHHHOHOHOHOHOH
OHOHOOOHOOOHOHOOOOOHOHOOOOOOOHOOOHOOOOOOOOOHOOOOOOOHOHOOOHOOOOOOOHOHOOOOOOOHOOOHOOOHOHOHOHOOOHOHOHOH
OHOHOHHHOHHHOHHHHHOHOHHHHHOHOHHHOHOHHHHHHHHHOHHHHHOHOHHHOHHHHHOHHHOHOHHHHHHHHHHHOHHHOHOHOHHHHHHHOHHH
OHOOOOOHOHOOOOOHOOOHOOOOOHOHOHOHOOOHOOOHOOOOOHOOOHOHOOOHOHOOOHOHOOOHOOOOOHOOOHOOOHOOOOOOOOOHOOOHOOOH
OHHHHHHHOHOHHHOHOHHHHHHHOHOHOHOHHHHHHHOHOHOHHHHHOHOHHHOHOHOHOHHHOHHHHHHHOHOHOHOHHHHHHHHHHHOHOHOHHHOH
OHOHOOOOOHOOOHOHOHOHOOOOOHOHOHOOOOOOOOOHOHOOOOOHOOOHOOOHOOOHOOOOOHOOOOOHOHOHOHOOOOOOOOOHOHOHOHOHOOOH
OHOHOHHHHHHHHHOHOHOHOHHHHHOHOHOHHHOHHHHHOHHHHHOHOHHHOHOHHHHHHHHHHHOHHHOHOHOHOHHHHHHHHHOHOHOHOHOHOHOH
OHOHOOOHOOOOOOOHOHOOOHOOOOOHOHOHOHOHOOOHOOOHOOOHOOOOOHOHOOOHOOOHOOOHOOOHOHOHOOOOOOOHOOOHOHOOOHOOOHOH
OHOHHHOHOHHHHHHHOHOHHHOHHHOHOHOHOHOHOHOHHHOHOHHHHHHHHHHHOHOHOHOHHHOHHHHHOHOHHHHHHHOHOHHHOHHHOHHHHHHH
OOOOOHOHOHOOOHOOOHOOOHOHOOOHOHOOOHOHOHOOOOOHOOOOOHOOOOOOOHOOOHOOOHOHOOOOOHOOOHOOOOOOOHOOOHOOOHOOOOOH
HHHHOHGHOHOHOHOHHHHHOHOHOHHHOHHHHHOHOHHHHHHHHHHHOHOHHHHHHHHHHHHHOHOHOHHHHHHHOHHHHHHHHHOHOHOHHHOHHHOH
OOOOOHSOOOOHOHOOOHOOOHOHOOOHOHOOOOOHOHOOOOOOOHOHOHOHOOOHOOOOOHOHOHOOOHOHOOOOOHOOOHOOOOOHOHOHOHOHOOOH
OHHHHHOHHHHHOHHHOHOHHHHHHHOHOHOHHHHHOHOHHHOHOHOHOHOHOHOHHHOHOHOHOHHHOHOHOHOHHHOHOHHHHHOHOHOHOHOHOHOH
OHOHOOOHOOOHOOOHOHOHOOOOOOOHOOOHOOOOOHOHOOOHOOOHOHOOOHOOOHOHOOOHOOOHOOOHOHOHOOOHOOOOOHOHOOOOOHOHOHOH
OHOHOHHHOHHHHHOHOHOHOHOHHHHHHHHHOHHHHHOHOHOHHHHHOHHHHHHHOHOHHHOHHHOHOHHHOHOHOHHHHHHHOHHHHHOHHHOHOHOH
OOOHOHOOOHOOOHOHOHOHOHOOOOOHOOOOOOOHOOOHOHOHOOOOOHOOOHOOOHOHOOOOOHOHOHOOOHOHOHOOOHOOOHOOOHOHOOOHOHOH
HHOHOHHHOHOHOHOHOHOHOHHHHHOHOHHHHHOHHHHHOHOHOHHHOHOHOHOHHHOHOHHHHHOHOHOHHHOHOHOHOHOHHHOHOHOHOHHHOHOH
OOOHOOOHOOOHOHOOOHOHOHOOOHOOOHOOOHOOOOOHOHOHOHOOOHOHOOOHOOOHOHOHOOOHOHOOOHOHOHOHOHOOOHOHOHOHOHOOOHOH
OHHHHHOHOHHHOHHHHHOHHHOHOHHHHHOHOHHHHHOHOHOHOHHHHHOHHHHHOHHHOHOHOHHHOHHHOHHHHHHHOHHHOHOHOHHHOHOHHHOH
OHOOOOOHOOOHOOOOOOOOOOOHOOOOOOOHOOOOOHOOOHOHOHOOOOOHOOOOOHOOOHOHOHOHOOOHOOOHOOOOOOOHOHOHOHOOOHOHOOOH
OHOHHHHHHHOHHHHHHHOHHHHHHHHHHHHHHHHHOHHHHHHHOHOHHHHHOHHHOHHHOHOHOHOHOHHHHHOHHHHHHHOHOHOHOHOHHHOHOHHH
OHOOOHOOOOOHOOOOOHOHOOOOOHOOOHOOOOOOOHOOOHOOOHOHOOOOOHOHOOOHOHOHOHOOOHOOOHOOOOOOOHOHOOOHOHOHOHOHOOOH
HHHHOHHHHHHHOHHHOHHHOHHHOHOHOHOHHHHHHHOHOHOHHHOHOHHHHHOHHHOHOHOHOHHHHHOHOHHHOHOHHHOHHHHHOHOHOHOHHHOH
OOOOOHOOOOOOOHOHOOOOOHOOOHOHOOOHOHOOOOOHOOOHOOOHOOOOOOOHOOOHOOOHOHOOOHOHOOOHOHOHOOOHOHOOOHOOOHOOOHOH
OHHHHHOHHHHHHHOHHHHHHHOHHHOHHHHHOHOHOHHHHHOHOHHHHHHHHHOHOHHHHHHHOHOHOHOHHHOHHHOHOHHHOHOHHHHHOHHHOHHH
OHOOOOOOOHOOOOOOOHOOOOOHOHOOOHOOOHOHOHOOOOOHOHOOOHOOOHOHOOOHOOOHOHOHOHOOOHOOOOOHOHOOOHOOOOOHOOOHOOOH
OHHHHHHHOHHHHHHHOHOHHHHHOHHHOHHHOHOHOHHHHHHHOHOHOHHHOHOHHHOHOHOHOHOHOHHHOHOHHHHHOHOHOHHHHHOHHHOHHHOH
OHOOOOOOOHOOOOOOOHOOOHOOOOOHOOOHOOOHOOOOOHOOOHOHOOOHOOOOOHOOOHOOOOOHOOOOOHOHOOOOOHOHOHOOOOOOOHOOOHOH
OHOHHHHHHHOHHHHHHHHHOHOHHHOHHHOHOHHHHHHHOHOHHHOHHHOHHHOHHHHHHHHHHHHHHHHHHHHHOHHHHHHHOHOHHHHHHHHHOHOH
OOOHOOOOOOOOOOOOOOOOOHOOOHOOOOOHOOOOOOOHOHOOOOOOOHOOOHOHOOOOOOOOOOOOOOOOOOOOOHOOOOOHOHOHOOOOOOOOOHOH
HHHHOHHHHHHHHHHHHHHHHHHHHHOHHHHHHHHHOHHHOHHHHHHHHHHHOHOHOHHHHHHHHHHHHHHHHHHHHHHHOHOHOHOHOHHHHHHHHHOH
OOOHOOOOOOOOOOOHOOOOOOOOOHOOOOOOOOOHOHOOOHOOOHOOOHOOOHOHOHOOOHOOOHOOOOOOOHOOOOOOOHOOOHOOOHOOOOOHOHOH
OHHHHHHHHHHHHHOHOHHHHHHHOHHHHHHHHHOHHHOHOHOHHHOHOHOHHHOHOHOHOHOHOHOHHHHHOHOHOHHHHHHHHHHHHHHHOHOHOHOH
OOOOOOOHOOOOOOOHOHOOOOOHOHOOOOOOOHOOOOOHOOOHOOOHOOOHOOOHOOOHOHOHOHOOOOOHOOOHOHOOOOOOOOOHOOOOOHOHOHOH
OHHHOHOHOHHHHHHHOHHHOHOHOHHHOHHHHHHHHHHHOHHHOHHHHHHHOHHHHHHHOHHHOHHHOHHHHHHHOHOHHHHHOHOHOHHHHHOHOHOH
OHOOOHOHOHOOOOOOOHOOOHOHOOOHOOOOOOOOOHOHOHOOOHOOOOOHOHOOOHOOOHOOOHOOOHOOOOOHOHOHOHOOOHOOOHOOOHOHOHOH
HHOHOHHHOHOHHHHHHHOHHHOHHHOHOHHHHHOHOHOHOHOHHHOHHHOHOHHHOHOHHHOHHHOHHHOHHHOHOHOHOHOHHHHHHHOHHHOHOHOH
OOOHOHOOOHOOOHOOOHOOOHOOOHOHOOOOOHOHOOOHOHOHOHOHOHOHOOOOOHOOOHOHOOOOOHOOOHOHOHOOOHOHOOOOOOOOOHOHOHOH
OHHHOHOHHHHHOHOHOHHHOHHHOHOHHHHHOHOHHHOHOHOHOHOHOHOHOHHHHHHHOHOHOHHHHHOHOHOHOHHHOHOHHHHHHHHHOHOHOHOH
OHOOOHOOOOOOOHOHOOOOOHOHOHOOOHOOOHOHOOOHOHOHOOOOOHOHOHOOOOOOOHOOOHOOOHOHOHOOOHOOOHOOOHOOOHOOOHOOOHOH
OHHHHHHHHHHHHHOHHHHHHHOHOHHHOHHHHHOHHHHHOHOHHHHHOHOHOHOHHHHHHHOHHHOHOHOHOHHHHHOHHHHHOHOHOHOHHHOHHHOH
OOOOOOOHOOOOOOOOOOOHOOOHOHOHOHOOOHOHOOOOOHOHOOOHOHOOOHOOOOOHOOOOOHOHOHOHOOOOOOOHOOOHOOOHOHOOOOOHOOOH
OHHHOHHHOHHHHHHHHHOHOHOHOHOHOHOHOHOHOHHHHHOHOHOHOHHHHHHHHHOHHHHHHHOHOHHHOHHHHHHHOHOHHHHHOHOHHHHHOHHH
OOOHOOOOOOOOOHOOOOOHOHOHOHOHOHOHOOOHOOOOOHOOOHOHOOOOOHOOOOOHOOOHOOOHOOOHOHOOOOOOOHOOOOOHOHOOOHOHOOOH
HHOHHHHHHHHHOHOHHHHHOHOHOHOHOHOHHHOHHHHHOHHHHHOHHHHHOHOHHHHHOHOHOHHHHHOHHHOHHHHHHHHHHHOHOHHHOHOHHHOH
OOOHOOOOOHOOOHOHOOOOOHOOOOOHOHOHOOOOOOOHOHOOOOOHOOOHOHOHOOOOOHOHOOOHOOOOOHOHOOOOOOOOOOOOOHOHOHOOOHOH
OHHHOHHHOHHHOHOHOHHHHHHHHHOHOHOHHHHHHHHHOHOHHHHHOHOHHHOHOHHHHHOHOHOHHHHHOHOHOHHHHHOHHHHHHHOHOHOHHHOH
OHOHOHOHOOOHOHOHOHOOOOOHOHOHOHOHOOOOOOOOOHOOOOOOOHOOOOOOOHOHOOOHOHOOOHOOOOOHOHOOOHOOOHOOOHOOOHOHOOOH
OHOHOHOHHHOHOHOHHHOHHHOHOHOHOHOHOHHHHHHHHHHHOHHHHHOHHHHHHHOHOHHHHHHHOHOHHHHHHHOHOHHHHHOHOHOHHHOHOHHH
OHOHOHOOOHOHOHOOOHOOOHOHOOOHOHOHOHOOOOOHOOOHOHOOOHOHOOOOOHOHOHOOOOOHOHOOOHOOOOOHOOOOOOOHOHOOOHOHOOOH
OHOHOHOHHHOHHHHHOHHHOHOHHHHHOHOHOHOHHHOHOHOHHHOHOHHHOHHHOHOHOHOHHHOHOHHHOHOHHHHHHHHHHHHHOHHHOHOHHHOH
OHOHOHOOOOOOOHOOOHOOOHOOOHOOOHOHOHOHOOOHOHOOOOOHOHOOOHOOOHOHOOOHOHOOOHOOOHOOOOOHOOOOOOOHOHOHOHOOOHOH
OHOHOHHHHHHHOHOHOHOHHHHHOHOHHHOHOHHHOHHHOHHHHHHHOHOHHHOHHHOHHHHHOHHHHHOHHHHHHHOHHHHHHHOHOHOHOHOHOHOH
OOOHOOOOOOOHOOOHOHOOOHOHOOOHOOOHOOOOOHOOOHOOOOOHOHOHOHOHOOOOOOOOOOOOOHOHOOOOOHOOOOOOOHOHOHOOOHOHOHOH
HHOHHHHHHHOHHHHHHHHHOHOHHHHHHHOHHHHHOHOHHHHHOHOHOHOHOHOHHHHHOHOHHHHHOHOHHHOHOHHHHHHHOHOHOHOHHHOHOHOH
OOOHOOOOOHOOOHOOOOOOOHOOOOOOOOOOOHOOOHOHOOOOOHOHOHOHOHOOOHOOOHOHOOOHOHOOOOOHOOOHOOOOOHOHOHOOOOOHOHOH
OHHHOHHHOHHHOHOHHHHHHHOHHHHHHHHHOHOHHHOHHHOHHHOHOHOHOHHHOHOHHHHHOHOHHHHHHHOHHHHHOHHHHHOHOHHHHHHHOHOH
OOOHOOOHOHOOOHOOOOOHOOOHOOOOOHOOOHOOOHOOOHOOOHOHOOOHOOOOOHOOOOOOOHOOOOOOOOOHOOOHOHOOOHOOOHOOOOOOOHOH
HHOHHHOHOHOHHHHHHHOHOHHHOHHHOHHHHHHHOHHHOHHHOHOHHHHHOHHHHHOHHHHHHHHHHHOHHHHHOHOHOHOHOHOHHHHHHHHHHHOH
OOOHOHOHOHOOOHOOOOOHOOOHOOOHOOOHOOOHOOOHOHOOOHOOOHOOOHOOOHOHOOOHOOOOOHOOOHOOOHOHOHOHOHOOOOOOOOOOOOOH
OHHHOHOHOHHHOHOHHHHHOHOHHHOHHHOHOHOHOHHHOHOHHHHHOHOHHHOHOHOHOHOHOHHHOHHHOHOHHHOHOHOHOHHHHHHHHHHHHHOH
OOOHOOOHOOOHOHOOOOOHOHOOOHOOOHOHOHOHOHOOOHOHOOOHOHOOOHOHOOOOOHOHOHOHOOOHOHOHOHOHOOOHOHOOOOOOOOOOOOOH
HHOHOHHHHHOHOHHHHHOHHHOHHHHHOHOHOHOHOHOHHHOHOHOHHHHHOHOHHHHHHHHHOHOHHHOHHHOHOHOHHHOHOHHHHHHHHHHHOHHH
OHOHOHOOOOOHOOOOOHOOOHOOOHOOOHOOOHOOOHOOOHOOOHOOOOOHOHOHOOOHOOOOOHOHOOOHOOOHOHOOOHOHOOOOOOOHOOOHOOOH
OHOHOHOHHHOHHHHHOHHHOHHHOHOHHHHHHHHHHHHHOHOHHHHHHHOHOHOHHHOHOHHHHHOHOHHHOHHHOHHHOHOHHHHHHHOHOHOHHHOH
OHOHOHOHOHOHOOOHOOOOOHOOOHOHOOOOOOOHOOOOOHOOOOOOOHOHOHOOOOOHOHOOOHOHOHOOOOOHOOOOOHOOOOOOOHOOOHOHOOOH
OHOHOHOHOHOHOHOHHHHHHHOHHHOHOHHHHHHHOHHHHHOHHHHHOHOHOHHHHHOHOHOHOHOHOHHHHHOHOHHHHHHHHHOHHHHHOHOHHHHH
OOOHOHOHOHOHOHOHOHOOOOOOOOOHOOOHOOOHOHOOOOOHOOOHOHOHOOOHOOOHOOOHOHOHOHOOOOOHOHOOOOOHOOOHOOOHOHOOOOOH
OHHHHHOHOHOHOHOHOHOHHHHHHHOHHHOHOHOHOHOHHHHHOHOHOHOHHHOHHHHHOHHHOHOHOHOHHHHHOHOHOHHHOHHHOHOHHHHHHHOH
OOOHOOOHOHOHOHOHOOOOOHOOOHOOOOOHOHOHOHOHOOOOOHOHOHOHOOOHOOOHOOOHOHOOOHOOOOOHOHOHOOOOOHOOOHOOOOOHOOOH
HHOHOHHHOHOHOHOHHHHHHHOHOHHHHHHHOHOHOHHHOHHHHHOHOHOHOHHHOHOHHHHHOHOHHHOHHHOHOHOHHHHHOHOHHHHHHHOHOHOH
OOOHOHOOOHOHOHOHOOOOOHOHOOOOOHOOOHOHOOOOOOOOOHOHOHOHOHOOOHOOOOOHOHOHOOOOOHOHOHOHOOOHOHOHOHOOOHOHOHOH
OHHHOHOHHHOHOHOHOHHHOHOHHHHHOHOHHHOHHHHHHHHHHHOHOHOHOHOHHHHHHHOHOHOHHHHHHHOHOHHHOHOHHHOHOHOHOHOHOHOH
OOOOOHOOOOOOOHOOOHOOOOOHOOOOOOOHOOOOOOOOOOOOOOOHOHOOOOOHOOOOOOOOOHOOOOOOOOOHOOOOOHOOOOOHOOOHOOOOOHOH
HHHHHHHHHHHHHHHHHHHHHHHHHHHHHHHHHHHHHHHHHHHHHHHHHHHHHHHHHHHHHHHHHHHHHHHHHHHHHHHHHHHHHHHHHHHHHHHHHHHH
