OOOOOOOOOOOOOOOOOHOOOOOOOOOOOHOOOOOOOOOHOOOOOOOOOOOOOOOOOHOOOHOOOOOOOOOHOOOOOOOOOOOOOOOHOOOOOOOHOOOH
OHHHHHOHHHHHHHHHOHOHOHHHHHHHOHOHHHHHHHHHOHHHHHHHHHOHHHHHOHHHOHOHHHOHHHOHOHHHHHOHHHOHHHOHHHHHOHHHOHOH
OHOOOHOHOHOOOHOOOHOHOHOOOOOHOHOOOOOOOOOOOHOOOOOOOHOHOOOOOOOHOOOHOOOHOHOHOHOOOHOOOHOHOHOHOOOOOHOOOHOH
OHOHHHOHOHOHOHOHHHHHOHOHHHOHOHOHHHHHHHHHHHOHOHHHHHOHHHHHHHOHHHHHOHHHOHOHHHOHOHOHHHOHOHOHOHHHHHOHHHOH
OOOHOOOHOOOHOOOHOOOOOHOOOHOOOHOHOOOOOHOOOOOHOHOOOHOHOOOOOHOOOHOOOHOOOHOOOOOHOHOHOOOHOHOHOOOOOHOHOOOH
HHOHOHHHOHHHHHHHHHOHHHHHOHHHHHOHHHOHOHOHHHOHHHOHOHOHOHHHOHHHOHOHHHOHOHOHHHHHOHHHOHHHOHOHHHHHOHOHOHHH
OOOHOHOHOOOOOOOOOOOHOOOHOOOHOHOOOOOHOHOHOHOHOOOHOHOHOOOHOOOHOOOHOHOHOHOHOOOHOOOOOHOOOHOHOOOOOHOHOOOH
OHHHOHOHHHHHHHHHHHHHOHOHHHOHOHHHHHHHOHOHOHOHOHHHOHOHHHOHHHOHHHHHOHOHOHOHOHOHHHHHHHHHOHOHOHOHHHOHHHOH
OOOHOHOOOOOHOOOOOHOOOHOHOOOHOHOOOOOHOHOHOOOHOHOHOOOHOOOHOHOOOOOHOOOHOOOHOHOOOOOHOOOHOOOOOHOHOOOHOHOH
HHOHOHOHHHOHHHOHOHOHOHHHOHHHOHOHHHOHOHOHOHHHOHOHHHOHOHHHOHHHHHOHHHHHHHHHOHHHHHOHOHOHHHHHHHOHOHHHOHOH
OOOHOHOHOHOOOOOHOHOHOHOOOHOOOHOHOHOOOHOHOHOOOHOHOOOHOHOOOOOOOHOOOHOOOOOOOHOHOOOHOHOOOHOOOOOHOHOOOHOH
OHHHOHOHOHHHHHHHOHHHOHOHHHHHOHOHOHHHHHOHOHOHHHOHOHHHOHOHHHHHHHHHOHOHHHHHHHOHOHHHOHHHOHHHHHHHOHHHOHOH
OOOHOHOHOHOOOHOOOHOOOHOOOHOOOHOOOOOOOHOHOHOHOOOHOOOHOHOOOHOOOOOOOHOHOOOHOOOHOOOOOOOHOOOHOOOHOHOOOHOH
HHOHOHOHOHOHOHOHHHOHHHHHOHOHHHHHHHHHOHOHHHOHOHOHHHOHOHHHOHOHHHHHHHOHOHOHHHOHHHHHHHHHHHOHOHOHOHOHHHOH
OOOHOHOHOOOHOHOOOHOHOOOOOHOOOOOOOOOHOOOHOOOHOHOOOOOHOOOOOHOOOOOOOHOOOHOOOHOOOOOOOHOOOHOOOHOOOOOHOOOH
OHHHOHOHHHHHOHHHOHOHOHHHHHHHHHHHOHOHHHOHOHHHHHHHOHHHHHHHOHHHHHHHOHHHHHHHOHOHHHHHOHOHOHHHHHHHHHHHOHHH
OHOHOHOOOHOOOHOOOOOHOHOOOOOOOOOHOHOOOHOHOHOOOOOHOOOOOOOHOHOOOOOHOOOOOOOHOHOOOHOOOHOHOHOOOOOOOOOHOOOH
OHOHOHOHOHOHHHOHHHHHOHOHOHHHHHOHOHOHHHOHOHOHHHOHHHHHHHHHOHOHHHHHHHOHHHHHOHHHOHOHOHOHOHOHHHHHHHOHOHOH
OHOHOHOHOHOOOOOHOOOOOHOHOOOOOHOOOHOHOOOHOHOHOHOHOOOOOOOOOHOHOOOOOHOOOOOOOHOOOHOHOHOHOHOHOOOOOHOHOHOH
OHOHOHOHOHHHHHHHOHHHHHOHHHHHOHHHHHOHOHHHOHOHOHOHOHHHHHHHHHOHOHHHOHHHHHOHHHHHHHOHOHOHOHOHOHHHOHOHOHOH
OOOHOHOHOHOOOOOHOOOHOHOOOHOHOHOOOOOHOHOHOOOOOHOOOOOOOOOHOOOOOOOHOHOOOHOOOHOOOOOHOHOHOOOHOHOHOHOHOHOH
HHOHOHHHOHOHHHOHHHOHOHHHOHOHOHHHHHHHOHOHHHHHHHHHHHHHHHOHHHHHHHHHOHOHOHHHOHOHHHHHOHOHHHHHOHOHOHOHHHOH
OHOHOOOHOOOHOOOOOHOHOOOOOOOHOOOOOOOOOOOHOOOOOOOOOOOHOOOOOOOOOOOOOHOHOHOOOHOHOOOHOHOHOOOOOHOHOOOHOOOH
OHOHHHOHOHHHOHHHOHOHHHHHHHHHHHHHHHHHHHHHOHHHHHHHHHOHOHHHHHHHHHOHHHOHOHHHOHOHOHOHOHOHHHOHHHOHHHHHOHOH
OOOOOHOHOHOOOHOHOHOOOOOOOOOOOOOHOOOHOOOOOHOOOOOHOOOHOHOOOOOOOHOHOOOHOOOHOHOOOHOHOHOOOHOOOOOOOHOOOHOH
HHHHHHOHOHOHHHOHOHHHHHHHHHHHHHOHOHOHOHHHHHOHOHOHOHHHHHOHHHHHOHOHOHHHHHOHOHHHOHOHHHHHOHOHHHHHOHHHOHOH
OOOOOOOHOHOHOOOHOOOOOOOOOOOOOHOOOHOOOHOOOHOHOHOHOOOHOOOHOOOHOHOHOHOOOOOHOOOHOHOHOOOOOHOHOOOHOOOHOHOH
OHHHHHHHHHOHOHHHHHHHHHHHHHHHOHHHHHHHHHOHHHOHOHHHHHOHOHHHOHOHOHHHOHHHHHOHHHOHHHOHOHHHHHHHOHOHHHOHOHOH
OHOOOOOOOOOHOHOOOOOOOOOOOOOHOHOOOOOOOHOOOHOHOOOOOOOHOOOHOHOHOOOHOOOOOHOHOHOOOOOHOHOOOOOOOHOHOOOOOHOH
OHHHOHHHOHHHOHOHHHOHHHOHHHHHOHHHHHHHOHOHOHOHHHHHHHHHOHOHOHHHHHOHHHHHOHOHOHOHHHHHOHOHHHHHHHOHHHHHHHHH
OOOHOOOHOOOHOOOHOOOHOOOHOOOOOHOOOOOOOHOHOHOOOOOOOHOOOHOHOOOOOOOOOOOOOHOHOOOHOOOOOHOHOOOOOHOOOOOHOOOH
HHOHHHOHHHOHOHHHOHHHHHHHOHHHHHOHHHHHOHOHOHHHHHHHOHOHHHOHOHHHHHHHHHHHHHOHHHHHOHHHHHOHOHHHOHHHHHOHOHOH
OOOHOOOHOOOHOOOHOOOOOOOOOHOOOOOHOHOOOHOHOOOOOHOOOHOOOHOHOOOHOOOHOOOOOHOOOOOOOHOOOHOHOOOHOOOOOHOOOHOH
OHHHOHHHOHHHHHHHHHHHHHOHHHOHHHHHOHOHHHOHHHHHOHOHHHHHOHOHHHHHOHOHOHHHOHHHOHHHHHOHOHOHHHOHHHHHOHHHHHOH
OOOHOOOHOOOOOHOOOOOOOHOOOOOHOOOOOOOHOOOHOOOHOOOHOOOHOHOHOOOHOHOOOHOHOOOHOHOOOOOHOHOOOOOHOOOOOHOHOOOH
OHOHHHOHHHHHOHOHHHHHOHHHHHHHOHHHHHHHOHHHOHHHHHHHHHOHOHOHOHOHOHHHHHOHHHOHOHOHHHHHOHHHHHHHOHHHHHOHOHHH
OHOHOOOHOOOHOOOHOOOHOOOOOOOHOOOHOOOOOHOHOOOOOOOOOOOHOHOOOHOHOOOHOOOOOHOHOHOHOOOHOOOHOOOOOOOOOOOHOOOH
OHOHOHHHHHOHHHHHHHOHHHHHHHOHHHHHOHHHHHOHOHHHHHHHOHHHOHHHHHOHHHOHHHHHOHOHOHOHHHOHOHHHOHHHHHHHHHHHOHOH
OHOHOHOOOOOOOHOOOOOHOOOHOHOOOOOOOHOOOHOOOHOOOOOHOOOHOOOHOHOOOOOOOHOOOHOHOHOOOOOHOOOOOHOOOOOOOOOHOHOH
HHOHOHOHHHHHOHHHOHOHOHOHOHHHHHHHHHHHOHOHHHOHHHOHHHOHHHOHOHHHHHHHOHOHOHOHOHHHHHOHHHHHHHOHHHHHHHOHHHOH
OOOHOHOOOHOHOOOOOHOOOHOHOOOOOHOOOOOOOHOHOOOHOHOHOHOOOOOHOOOHOOOHOOOHOHOHOOOHOOOHOOOOOHOOOHOOOHOOOHOH
OHHHOHOHOHOHOHHHHHHHHHOHOHHHOHOHHHOHHHOHOHOHOHOHOHHHHHHHHHOHOHOHHHHHOHOHHHOHOHHHHHHHOHHHOHOHHHHHOHOH
OHOHOHOHOHOOOHOOOOOHOOOHOOOHOHOOOHOOOHOHOHOHOOOOOOOOOOOOOOOHOHOOOHOOOHOHOOOHOOOHOOOOOOOHOHOOOOOOOHOH
OHOHOHHHOHHHHHOHHHOHHHOHHHOHOHHHHHHHOHOHOHOHHHHHHHHHHHHHHHHHOHHHOHOHHHOHHHHHHHOHOHHHHHHHOHHHOHHHHHOH
OHOOOOOHOHOOOHOOOHOOOHOOOOOHOOOOOOOOOHOHOHOOOOOHOOOOOOOOOHOOOHOHOHOOOHOOOOOOOOOOOHOOOOOHOOOHOOOOOHOH
OHHHHHOHOHOHOHHHOHHHOHOHHHHHHHHHHHHHOHOHHHOHHHOHOHHHHHHHOHOHHHOHOHHHOHHHHHHHHHHHOHOHHHOHHHOHHHHHOHOH
OHOOOHOHOOOHOOOOOHOOOHOHOOOHOOOOOHOHOHOOOHOOOHOHOHOOOOOHOOOHOHOOOHOOOHOOOOOOOHOOOHOOOHOOOHOOOOOHOOOH
OHOHOHOHOHHHHHHHOHOHHHOHOHOHOHHHOHOHOHHHOHHHHHOHOHHHOHOHHHHHOHOHHHHHHHOHHHHHOHOHHHHHOHHHOHHHHHOHHHOH
OOOHOHOHOOOHOOOHOHOHOOOHOHOHOOOHOHOOOOOHOOOOOHOHOOOHOHOHOOOOOHOHOOOOOHOOOOOHOHOOOHOOOHOOOOOOOOOHOHOH
OHHHOHOHHHHHOHOHHHOHHHHHOHOHHHOHOHHHHHHHHHHHOHOHHHOHOHHHOHOHOHOHHHOHOHHHHHOHOHHHOHOHHHHHHHHHHHHHOHOH
OHOOOHOOOOOHOHOOOHOOOHOOOHOOOOOHOOOOOHOOOHOOOOOOOHOHOHOOOHOHOHOOOOOHOOOHOOOHOOOHOHOHOOOHOOOOOOOHOOOH
OHOHHHHHHHOHOHHHOHHHOHOHHHHHHHHHHHHHOHOHOHOHHHHHHHOHOHOHHHOHHHHHHHHHHHOHOHHHHHOHOHOHOHOHOHOHHHHHOHHH
OHOHOOOHOOOOOHOHOOOHOHOOOOOOOHOOOOOHOHOHOOOHOOOOOOOHOHOOOHOHOOOOOHOOOHOOOHOHOOOHOHOOOHOHOHOOOHOOOHOH
OHOHOHOHHHHHHHOHHHOHOHHHHHHHOHOHHHOHOHOHHHHHOHHHHHHHOHHHOHOHOHHHOHOHOHHHHHOHOHHHHHHHHHOHOHHHOHOHHHOH
OHOOOHOOOOOOOHOOOOOHOOOOOOOOOOOHOOOHOOOHOOOHOOOHOOOOOOOOOHOOOHOOOHOHOOOOOHOHOOOOOOOOOOOHOOOHOHOHOOOH
OHHHHHHHHHHHOHOHHHHHOHHHHHHHHHHHHHHHHHHHOHOHHHOHHHHHHHHHOHHHHHOHHHOHHHOHOHOHHHHHHHHHHHHHHHHHOHOHOHHH
OHOOOOOOOOOHOHOHOOOHOOOHOHOOOOOOOOOOOHOOOHOHOOOHOOOOOOOHOHOOOHOHOOOOOHOHOOOOOOOHOOOOOOOOOOOOOHOHOOOH
OHHHHHHHOHHHOHOHOHOHHHOHOHOHHHHHHHHHOHOHHHOHOHHHOHHHHHOHOHOHOHOHOHHHHHOHHHHHHHOHOHHHHHOHHHHHOHOHOHOH
OOOOOHOOOHOOOHOHOHOOOHOHOHOHOOOOOOOHOHOHOHOHOHOOOHOOOHOHOOOHOHOOOOOHOOOHOOOOOHOHOHOOOHOHOOOOOHOHOHOH
HHHHOHOHOHOHHHOHOHHHOHOHOHOHHHHHOHHHOHOHOHOHOHOHOHOHOHOHHHHHOHHHHHHHOHHHOHHHOHOHOHHHOHOHHHHHHHOHHHOH
OOOOOOOHOHOOOHOHOOOHOHOOOHOHOOOHOOOHOOOHOHOHOHOHOHOHOHOHOOOOOHOOOOOOOHOHOOOHOOOHOOOOOHOOOOOOOOOHOOOH
HHHHHHHHOHHHOHOHOHOHHHHHOHOHOHOHHHOHHHHHOHOHOHHHOHOHHHOHOHHHHHOHHHHHHHOHHHOHHHHHHHHHOHHHHHHHHHHHOHHH
OOOOOOOHOOOHOHOHOHOOOOOHOHOHOHOHOOOHOOOHOOOHOHOOOHOOOHOHOHOOOHOHOOOOOOOOOHOOOHOOOHOOOHOHOOOOOHOOOOOH
OHHHHHOHHHHHOHOHHHHHOHOHOHOHOHOHOHOHHHOHOHHHOHOHHHHHOHOHHHOHOHOHHHHHHHOHOHHHOHHHOHOHHHOHOHOHHHOHHHOH
OHOOOOOHOOOOOHOOOOOHOHOHOHOHOHOOOHOOOOOHOHOOOHOHOOOHOOOOOOOHOHOOOHOOOOOHOHOHOOOHOHOOOHOOOHOOOHOOOHOH
OHHHOHHHOHHHHHHHHHOHHHOHOHOHOHHHHHHHHHOHOHOHOHOHOHOHHHHHHHHHOHOHOHOHHHHHOHOHHHOHOHHHOHHHOHHHOHHHOHOH
OOOHOHOOOHOOOOOHOHOOOHOOOHOHOOOHOOOOOHOHOHOHOHOHOHOOOHOOOOOHOHOHOHOOOOOHOOOOOHOOOOOHOOOHOOOHOOOOOHOH
HHOHOHOHHHOHHHOHOHHHOHHHHHOHHHOHOHHHHHOHOHHHOHOHOHHHOHOHHHOHOHOHOHOHHHOHHHHHHHHHHHOHHHOHHHOHHHHHHHOH
OOOHOOOHOOOHOOOOOHOOOHOOOOOHOOOHOHOOOOOHOOOOOHOOOHOHOHOHOOOHOHOHOHOHOOOHOOOHOOOOOHOOOHOOOHOOOOOHOOOH
OHHHHHHHOHOHHHHHHHOHHHOHHHHHOHHHOHOHHHHHHHHHHHOHHHOHOHOHOHOHOHHHOHHHOHOHOHOHOHOHHHOHHHHHOHOHHHHHOHOH
OOOOOOOHOHOHOOOOOOOOOOOHOOOOOHOOOOOOOOOHOOOOOHOHOOOHOHOHOHOHOHOOOHOOOHOHOHOHOHOHOOOHOOOHOHOHOOOOOHOH
OHHHHHOHHHOHOHHHHHHHHHHHOHHHHHOHHHHHHHOHOHHHOHOHOHOHOHHHOHHHOHOHHHOHHHHHOHOHOHOHOHHHOHOHOHHHOHHHHHOH
OHOOOHOOOHOHOHOOOHOHOOOHOHOOOOOHOOOHOHOHOOOHOOOHOHOHOOOHOOOOOHOOOHOOOHOOOHOOOHOOOHOOOHOOOHOOOHOOOHOH
HHOHOHHHOHOHOHOHOHOHOHOHOHHHOHHHOHOHOHOHOHHHHHOHHHOHHHOHOHHHHHOHOHOHOHOHHHHHHHHHOHOHHHHHHHOHHHHHOHOH
OOOHOOOOOHOOOOOHOOOHOHOHOOOHOHOOOHOHOHOHOHOOOHOOOOOHOOOHOHOOOHOHOHOHOOOOOOOHOOOHOHOOOHOOOOOHOOOOOHOH
OHHHHHHHHHOHHHHHHHHHOHOHOHOHHHOHHHOHOHOHHHOHOHHHHHOHOHHHOHOHOHOHOHHHHHHHHHHHOHOHOHHHOHOHHHHHOHHHOHOH
OHOOOOOOOHOHOHOOOOOOOHOHOHOOOOOHOHOHOOOOOOOHOHOOOHOHOOOHOOOHOHOHOOOOOHOOOHOOOHOHOOOHOHOHOOOOOHOOOHOH
OHHHHHOHOHOHOHOHHHHHHHOHHHOHHHHHOHOHHHHHHHHHOHOHOHOHHHOHHHHHOHHHHHHHOHOHOHOHHHOHHHHHOHOHHHOHHHOHHHOH
OOOOOHOHOOOHOHOOOOOHOHOOOHOOOOOHOHOOOOOOOHOOOHOHOHOOOHOOOHOOOOOOOHOOOHOHOOOHOHOOOOOOOHOHOOOHOOOOOHOH
OHHHOHOHHHHHOHHHHHOHOHHHOHHHHHOHOHHHHHHHOHOHHHOHOHHHOHHHOHHHHHHHOHOHOHOHHHHHOHHHHHHHHHOHOHHHHHHHOHOH
OOOHOHOOOHOOOOOOOHOHOOOHOOOHGHOOOHOOOOOOOHOOOOOHOHOHOOOHOOOOOHOHOHOHOHOHOOOHOOOOOOOOOOOHOOOHOOOHOHOH
HHHHOHHHOHOHHHOHOHOHOHHHHHOHOHHHHHOHHHHHOHHHHHHHOHOHHHOHHHHHOHOHOHOHOHOHOHOHOHHHHHOHHHHHOHOHOHOHOHOH
OOOOOHOOOHOOOHOHOHOHOOOOOHOHSOOOOHOHOOOHOHOOOOOHOHOOOOOOOOOHOHOOOOOHOHOHOHOOOHOOOOOHOOOOOHOOOHOHOHOH
OHHHHHOHHHOHHHOHOHOHOHHHOHOHHHHHOHOHOHHHOHOHHHOHOHHHHHHHHHOHOHOHHHHHHHOHHHHHOHOHHHHHOHHHHHHHHHOHOHOH
OOOHOOOOOHOHOOOHOHOHOOOHOHOOOOOHOHOHOOOOOHOHOOOHOOOOOOOHOOOHOHOHOOOOOOOHOOOHOHOOOHOOOHOOOOOOOHOHOHOH
OHOHHHHHOHHHOHHHOHOHHHOHOHOHHHHHOHOHOHHHHHOHOHHHHHHHHHOHOHHHOHOHOHHHHHHHOHOHHHOHOHOHHHOHHHHHOHOHHHOH
OHOHOOOHOOOOOHOHOHOHOHOHOHOOOOOOOHOHOHOHOOOHOHOOOHOOOHOHOOOHOHOHOHOOOOOOOHOOOHOHOHOOOHOOOOOHOHOHOOOH
HHOHOHOHHHHHHHOHOHOHOHOHOHHHHHHHHHOHOHOHOHHHOHOHOHOHOHOHHHHHOHHHOHOHOHHHHHHHOHOHOHHHOHHHHHOHOHOHOHHH
OOOHOHOOOOOHOOOOOHOHOHOHOOOHOOOOOOOHOOOHOHOHOOOHOHOHOHOOOOOOOHOOOHOHOOOHOOOHOHOHOOOHOOOHOHOHOHOHOHOH
OHOHOHHHHHOHHHHHOHOHOHOHOHOHOHHHOHHHHHOHOHOHHHHHOHOHHHHHOHHHHHOHHHOHHHOHOHOHOHHHHHOHHHOHOHOHOHOHOHOH
OHOHOHOHOOOHOOOHOHOHOOOHOHOHOOOHOOOHOHOHOOOHOOOOOHOHOOOOOHOOOOOHOOOOOHOOOHOHOOOHOOOHOHOHOOOHOHOOOHOH
OHHHOHOHOHHHOHOHHHOHHHHHOHHHHHOHHHOHOHOHOHHHOHHHHHOHOHHHHHOHHHHHOHHHHHHHHHOHHHOHOHHHOHOHHHHHOHHHHHOH
OOOHOOOHOHOOOHOHOOOHOOOOOHOOOOOHOHOHOOOHOHOOOHOOOHOOOHOOOHOOOOOHOHOOOOOOOOOHOHOHOHOHOOOHOOOOOHOOOOOH
OHOHHHOHOHOHHHOHOHHHOHHHHHOHHHHHOHOHHHHHOHOHHHHHOHOHHHOHOHHHHHOHOHOHHHHHHHHHOHOHOHOHOHHHOHHHOHHHOHOH
OHOOOOOHOOOHOOOHOOOHOHOOOHOHOOOOOHOOOOOOOHOOOOOHOOOHOOOHOOOOOHOHOHOOOHOHOOOOOHOOOHOOOHOOOOOHOOOHOHOH
OHHHHHHHHHHHOHOHHHOHOHOHOHOHOHOHOHHHHHHHHHHHHHOHHHOHOHHHHHHHOHOHHHHHOHOHOHOHHHHHHHOHHHHHHHOHHHOHOHHH
OOOHOOOOOOOHOHOHOOOHOOOHOOOHOHOHOOOOOHOOOOOOOHOOOHOOOHOOOOOHOHOHOOOOOHOHOHOOOOOOOHOHOOOOOHOOOHOHOOOH
HHOHOHHHHHOHOHHHOHHHOHHHHHHHHHOHHHHHOHHHOHHHOHHHOHHHHHOHHHOHHHOHOHHHHHOHOHHHOHHHHHOHHHOHOHHHOHOHHHOH
OOOOOHOOOOOHOOOOOHOOOOOOOOOOOOOHOOOOOOOOOHOOOOOHOOOOOOOOOHOOOOOOOHOOOOOOOOOHOOOOOOOOOOOHOOOOOHOOOOOH
HHHHHHHHHHHHHHHHHHHHHHHHHHHHHHHHHHHHHHHHHHHHHHHHHHHHHHHHHHHHHHHHHHHHHHHHHHHHHHHHHHHHHHHHHHHHHHHHHHHH
