OOOHOOOOOOOHOOOOOOOOOOOOOOOHOHOOOOOOOOOOOHOOOOOOOOOOOOOOOOOHOOOOOOOOOOOOOHOOOOOOOOOHOOOOOOOHOOOOOOOH
OHOHOHHHOHOHHHHHHHOHHHHHHHOHOHOHHHHHHHOHOHHHHHOHHHHHOHHHHHOHOHHHOHHHHHHHOHOHHHHHHHOHHHHHOHOHOHHHHHOH
OHOHOOOHOHOHOOOOOHOHOOOOOHOHOOOHOOOOOHOHOOOOOHOOOOOHOOOHOHOHOHOOOHOOOOOHOOOHOOOOOHOHOOOOOHOHOOOHOOOH
OHOHHHHHOHOHOHHHOHOHOHHHOHOHOHHHOHHHOHOHHHHHOHHHHHHHHHOHOHOHOHOHHHOHHHHHHHHHHHOHOHOHOHHHHHOHOHHHOHOH
OHOOOHOOOHOHOHOHOOOHOOOHOOOHOHOHOOOHOHOHOOOHOOOOOOOOOOOHOHOHOHOHOHOOOOOOOOOOOOOHOHOOOHOOOOOHOHOOOHOH
OHHHOHOHHHOHOHOHHHHHHHOHHHHHOHOHOHOHHHOHOHHHHHHHHHHHHHHHOHOHHHOHOHOHHHOHHHOHHHHHOHHHHHOHHHHHHHOHHHOH
OOOHOOOHOOOHOHOOOOOOOHOOOHOHOHOOOHOOOHOHOOOOOOOOOOOOOOOOOHOOOHOHOHOHOHOHOOOHOOOHOHOOOOOHOOOOOOOHOOOH
OHOHHHHHOHHHOHOHOHHHOHHHOHOHOHHHHHHHOHOHHHHHHHHHOHHHOHHHHHHHOHOHOHOHOHOHHHOHOHOHHHOHHHHHOHHHOHHHOHHH
OHOHOOOHOHOOOHOHOOOHOHOHOHOHOOOOOOOHOHOOOOOHOOOHOHOHOOOOOOOHOOOHOHOHOHOOOHOHOHOOOHOHOOOHOOOHOHOOOHOH
HHOHOHOHOHHHOHOHHHOHOHOHOHOHHHHHHHOHOHHHHHOHOHOHOHOHHHHHHHOHHHHHOHOHOHHHOHOHOHHHOHOHOHOHHHHHOHOHHHOH
OOOHOHOHOOOOOHOOOHOHOOOHOHOOOOOOOHOHOOOOOHOOOHOHOHOOOHOOOHOOOOOHOOOHOHOOOHOHOOOHOOOHOHOOOOOOOHOOOOOH
OHHHHHOHHHHHHHOHHHOHOHHHOHHHHHOHHHOHHHOHHHHHHHOHOHOHOHHHOHHHHHOHOHHHOHOHHHOHHHOHHHHHOHHHHHHHHHHHHHOH
OOOOOHOOOOOHOOOHOOOHOHOOOHOOOHOOOHOOOOOHOOOOOHOHOOOHOOOHOOOOOHOOOHOOOHOOOHOHOOOHOOOHOOOHOOOOOOOOOHOH
HHHHOHOHOHHHOHHHOHHHHHOHHHOHOHHHOHOHHHHHOHHHOHOHHHHHHHOHOHHHOHHHHHOHOHHHOHHHOHHHOHHHOHOHOHHHHHHHOHOH
OOOHOHOHOOOOOOOHOOOHOOOHOOOHOOOOOHOHOOOOOHOHOHOOOHOOOOOHOOOHOOOOOHOHOOOHOHOOOHOOOHOOOHOOOHOOOOOHOHOH
HHOHOHHHHHHHHHHHHHOHOHHHOHOHHHHHHHOHOHHHHHOHOHOHOHHHOHHHHHOHOHHHOHOHHHOHOHOHHHOHOHOHHHHHHHOHHHOHOHHH
OOOHOHOOOHOOOHOOOOOHOHOHOHOOOOOOOOOHOOOHOOOHOHOHOOOHOOOOOHOHOOOHOHOHOOOHOHOHOOOHOHOOOHOOOOOHOOOHOOOH
OHHHOHOHOHOHOHOHHHHHOHOHOHHHHHHHHHHHHHOHOHOHOHOHHHOHHHHHOHHHHHOHOHOHOHHHOHOHHHOHHHHHOHOHHHOHOHHHHHOH
OOOHOOOHOOOHOHOOOOOOOHOHOOOHOOOOOHOOOHOHOHOHOHOHOHOHOOOHOOOOOOOHOHOHOOOHOHOHOOOHOOOOOHOOOHOHOOOOOHOH
HHOHHHHHHHHHOHOHHHHHHHOHHHOHOHOHHHOHOHOHOHHHOHOHOHOHOHOHHHHHHHHHOHHHHHOHOHOHOHHHOHHHHHHHOHOHHHHHHHOH
OOOOOHOOOOOOOHOHOOOOOHOOOOOHOHOHOOOHOOOHOOOOOHOOOHOHOHOOOOOHOOOHOHOOOHOHOOOHOOOOOOOOOOOHOHOOOHOOOOOH
OHHHHHOHHHHHHHOHOHHHHHOHHHHHOHHHOHHHHHHHOHHHHHHHHHOHOHOHHHHHOHOHOHOHOHOHHHHHOHHHHHHHHHOHHHHHOHOHHHOH
OHOOOOOHOOOOOOOHOHOOOHOHOOOHOHOOOHOHOOOOOHOOOOOOOOOHOHOOOOOOOHOHOOOHOOOHOOOHOHOOOHOOOHOOOOOHOHOHOOOH
OHOHHHHHHHOHHHHHOHOHOHOHOHOHOHOHHHOHOHHHHHOHHHHHHHHHOHHHHHHHHHOHHHHHHHOHHHOHOHOHOHOHHHHHHHOHOHOHHHHH
OHOOOOOOOHOHOOOHOOOHOOOOOHOOOHOHOOOOOOOOOOOHOOOHOOOHOHOOOOOHOOOOOOOHOHOOOHOOOHOHOHOOOOOHOOOOOHOOOOOH
OHHHHHHHOHOHOHOHOHHHHHHHHHOHHHOHHHHHHHHHHHHHOHOHHHOHOHHHHHOHOHHHHHOHOHHHOHHHHHOHOHHHOHHHOHHHHHHHHHOH
OOOHOOOOOHOOOHOHOOOOOHOOOHOHOOOHOOOOOHOOOHOOOHOOOOOHOOOOOHOHOHOOOHOHOOOHOOOOOOOHOOOHOOOHOHOOOHOOOOOH
HHOHOHHHHHHHHHOHHHHHHHOHOHHHOHOHOHHHOHHHOHOHOHHHHHHHHHHHOHOHOHOHOHOHHHOHHHHHHHHHHHOHOHOHOHOHOHOHHHHH
OOOHOOOHOOOOOOOOOHOOOOOHOOOHOHOHOOSHOHOOOHOHOOOOOOOOOOOOOHOHOOOHOHOOOOOOOOOOOOOHOOOHOHOOOHOHOHOOOOOH
OHHHHHOHHHHHHHHHOHOHHHHHHHOHOHHHHHGHOHOHOHOHHHHHHHHHHHHHHHOHHHHHOHHHHHHHOHHHHHHHOHHHOHHHHHOHOHHHOHOH
OOOOOHOOOOOOOHOOOOOHOOOOOOOHOOOOOHOOOHOHOHOOOHOOOOOOOOOOOOOOOHOOOHOOOOOOOHOOOHOOOHOOOHOOOHOHOOOHOHOH
OHHHOHHHHHHHOHHHHHHHOHHHHHHHOHHHOHOHHHOHHHHHOHHHHHHHHHHHOHHHOHOHHHOHHHHHHHOHOHOHHHOHHHHHOHOHHHOHOHOH
OHOOOHOOOOOHOOOHOOOHOHOOOOOHOHOHOHOOOHOOOOOOOHOOOOOOOOOHOHOHOHOHOHOOOHOHOOOHOOOHOOOOOOOOOHOOOHOHOHOH
OHOHOHOHHHOHHHOHOHOHOHOHHHOHOHOHOHHHOHOHHHHHHHOHHHHHHHOHOHOHOHOHOHHHOHOHOHHHHHHHHHHHHHHHOHHHOHOHHHOH
OHOHOHOHOOOOOHOHOHOHOOOHOOOHOOOHOOOHOHOOOHOOOHOOOHOHOOOHOOOHOHOHOOOOOOOHOOOOOHOOOOOOOOOHOOOHOHOOOHOH
HHOHHHOHOHHHOHOHOHHHHHHHOHHHHHHHHHOHOHHHOHOHOHOHOHOHOHHHHHOHOHOHHHHHHHHHHHHHOHHHOHHHHHOHOHHHOHHHOHOH
OOOHOOOHOHOOOHOHOHOOOOOHOHOOOOOOOHOHOOOHOHOHOHOHOHOOOHOHOOOHOHOOOOOOOOOOOOOOOHOOOHOOOHOHOHOOOHOHOHOH
OHHHOHHHOHOHHHOHOHOHHHOHOHHHOHHHOHOHHHOHOHHHOHOHOHOHHHOHOHHHOHHHHHHHHHHHHHHHHHOHHHOHOHOHHHOHHHOHOHOH
OOOOOOOHOHOOOHOHOOOHOHOHOOOOOHOOOOOOOHOHOOOHOOOHOHOOOHOOOHOHOOOOOOOOOOOOOOOOOHOHOOOHOHOOOOOHOHOOOHOH
HHHHHHHHOHHHOHOHHHOHOHOHHHHHOHHHHHHHHHOHHHOHHHHHOHHHOHOHHHOHHHHHHHHHHHOHHHHHOHOHHHOHOHHHHHHHOHOHHHOH
OOOOOOOOOHOHOHOOOHOOOHOHOOOOOHOOOOOOOOOHOHOOOOOOOHOOOHOOOHOOOOOOOHOOOOOHOOOHOHOOOHOHOHOOOHOOOHOOOHOH
OHHHHHHHHHOHOHHHOHHHOHOHOHHHHHOHHHHHHHHHOHHHHHHHHHOHHHHHOHOHHHHHHHOHHHHHHHOHOHHHOHHHOHOHOHOHOHHHOHOH
OHOOOOOOOHOOOOOHOHOOOHOOOHOOOHOOOOOOOHOOOOOOOHOOOHOHOHOOOHOOOHOOOOOHOOOOOHOHOOOHOOOHOHOHOOOHOOOHOHOH
OHHHOHOHHHOHHHHHOHOHHHHHHHOHOHHHHHHHOHOHHHHHHHOHOHOHOHOHHHHHOHOHHHHHHHOHOHOHHHOHOHOHOHOHHHHHHHOHOHOH
OOOHOHOOOOOHOHOOOHOOOOOOOOOHOHOOOOOHOHOOOOOOOOOHOHOHOOOHOOOOOHOOOHOOOOOHOHOHOOOHOHOHOHOOOHOOOOOHOOOH
HHOHOHHHHHHHOHOHHHHHHHHHHHHHOHOHOHHHOHOHHHHHHHHHOHOHOHHHHHOHHHHHOHOHOHHHOHOHOHHHHHOHOHOHHHOHHHHHHHOH
OOOHOHOOOOOOOHOOOOOOOHOOOOOHOHOHOOOOOHOOOOOHOOOHOOOHOOOOOOOHOOOOOHOHOHOOOHOHOOOOOOOHOOOHOOOHOOOOOOOH
OHHHOHOHHHOHHHHHHHHHOHOHHHOHHHOHHHHHHHHHHHOHOHOHHHHHHHHHHHHHOHHHHHOHOHOHHHOHHHHHHHHHHHHHOHOHOHHHHHHH
OHOOOHOOOHOHOOOHOOOOOHOHOHOOOOOHOOOOOOOHOHOHOHOOOHOOOOOOOOOOOHOOOHOHOHOOOOOHOOOOOOOOOOOHOHOHOHOOOOOH
OHHHOHHHOHHHOHOHOHHHOHOHOHHHHHHHOHHHOHOHOHOHHHOHOHHHOHHHHHHHHHHHOHOHOHHHHHOHHHHHOHHHHHOHOHHHOHOHHHHH
OOOHOOOOOHOOOHOOOHOHOHOHOOOHOOOOOHOHOHOOOHOOOOOHOOOHOHOOOOOOOOOHOOOHOHOOOHOOOOOOOHOOOHOOOHOOOHOOOOOH
OHOHHHHHHHOHHHHHHHOHOHOHOHOHOHHHHHOHOHHHOHHHHHHHHHOHOHHHOHHHOHOHHHHHOHOHOHHHHHOHHHOHOHHHOHOHHHHHHHOH
OHOOOOOOOHOOOHOOOOOOOHOHOHOHOOOHOOOHOHOHOHOHOOOOOOOHOOOHOHOOOHOOOHOOOHOHOOOOOOOHOOOHOHOOOHOOOHOOOOOH
OHHHHHHHOHHHOHHHHHHHHHOHOHOHHHOHHHOHOHOHOHOHOHHHHHHHHHOHHHOHHHHHOHOHOHHHHHHHHHHHOHHHOHOHHHHHOHOHHHOH
OHOOOOOHOOOHOHOOOHOOOHOOOHOOOHOOOOOHOHOOOOOHOHOOOOOOOHOOOHOOOOOHOOOHOHOOOOOHOOOHOHOOOHOOOOOHOHOHOOOH
OHOHHHHHHHOHOHOHOHOHOHHHHHHHOHHHHHOHOHOHHHHHOHOHHHHHOHOHOHHHOHOHHHHHHHOHHHOHOHOHOHOHHHHHHHOHOHOHOHHH
OOOHOOOOOHOHOOOHOOOHOHOOOOOHOOOHOOOHOHOOOHOOOHOOOHOOOHOHOOOHOHOOOOOHOOOHOOOHOHOOOHOOOOOHOOOHOHOHOOOH
HHHHOHHHOHOHHHHHHHHHOHOHHHOHHHOHHHHHOHOHHHOHHHOHOHOHHHHHHHOHOHHHHHOHOHHHOHOHOHHHHHHHHHOHOHHHOHOHHHOH
OOOOOHOOOOOOOHOOOOOHOOOHOOOOOHOOOOOHOHOHOOOHOOOHOHOOOOOOOOOHOOOOOHOOOOOHOHOHOOOOOOOHOOOHOOOHOHOHOHOH
OHHHHHHHHHHHOHOHOHHHHHHHOHOHHHHHHHOHOHHHOHHHOHHHOHHHHHHHHHHHHHHHHHHHHHHHOHHHHHHHHHOHOHHHHHOHOHOHOHOH
OHOOOHOOOHOOOHOHOOOOOOOHOHOHOOOHOOOHOOOHOHOOOHOOOHOOOOOOOHOOOOOOOOOOOOOOOHOOOOOOOOOHOHOOOOOHOOOHOOOH
OHOHOHOHOHOHHHOHHHHHHHOHOHHHOHOHOHHHOHOHOHHHHHOHHHHHOHHHOHHHOHHHHHHHHHOHHHOHHHHHHHHHOHHHOHHHHHHHOHHH
OOOHOOOHOHOHOOOHOOOOOHOHOHOOOHOHOHOHOHOHOOOOOHOHOOOOOHOOOOOOOHOOOOOOOHOHOOOHOOOOOOOHOOOHOOOHOOOHOHOH
OHHHHHHHOHHHOHHHOHHHHHOHOHOHHHOHOHOHOHOHHHHHOHOHOHHHHHOHHHHHHHOHOHHHHHOHOHHHOHHHHHOHHHOHHHHHOHOHOHOH
OOOHOOOHOOOHOOOHOOOOOHOHOOOHOHOOOHOOOHOOOHOOOHOHOHOOOHOHOOOOOHOHOOOOOHOHOHOOOOOOOHOOOHOHOOOOOHOHOOOH
OHHHOHOHHHOHHHOHHHHHOHOHHHHHOHHHHHHHHHOHHHOHHHOHOHOHOHOHOHHHOHHHHHHHOHOHOHOHHHHHOHHHOHOHOHHHHHOHHHOH
OHOOOHOOOOOOOHOOOOOOOHOOOOOOOOOOOOOOOHOOOHOOOOOHOHOHOOOHOHOHOOOOOOOHOHOHOHOOOOOHOOOHOHOOOHOOOHOHOOOH
OHOHHHHHHHHHOHHHHHHHOHHHHHHHHHHHOHHHOHHHOHHHHHHHOHOHHHHHOHOHHHHHHHOHOHOHOHHHHHOHHHOHOHHHHHHHOHOHOHHH
OHOOOHOOOOOHOOOOOOOHOOOHOOOOOHOHOOOHOOOHOOOOOOOOOHOOOOOHOHOHOOOOOHOHOOOHOOOHOHOHOOOHOHOOOOOOOHOHOHOH
OHHHOHOHHHOHHHHHHHOHHHOHHHOHOHOHHHOHHHOHHHOHHHOHHHHHOHHHOHOHOHHHOHOHHHHHHHOHOHOHOHHHHHOHOHHHOHOHOHOH
OHOHOOOHOHOOOOOHOOOHOOOHOOOHOHOOOHOHOHOOOHOHOOOHOOOHOHOOOHOOOOOHOHOOOOOOOOOHOOOHOOOOOOOHOHOHOHOOOHOH
OHOHHHHHOHHHHHOHHHHHOHHHOHHHOHOHHHOHOHHHOHOHHHHHOHOHOHOHHHHHHHHHOHHHHHHHHHHHOHHHHHOHHHHHOHOHOHHHHHOH
OOOOOOOOOHOOOHOOOHOOOOOOOHOOOOOHOOOHOOOOOHOOOHOOOHOHOHOOOOOHOOOOOOOHOOOOOOOOOHOOOHOOOHOOOHOOOOOOOOOH
HHHHHHHHOHOHOHHHOHOHHHHHHHHHHHHHOHHHOHHHHHOHOHOHHHOHOHHHHHOHOHHHHHOHHHHHHHHHHHOHOHHHHHOHOHHHHHHHHHOH
OOOOOHOOOHOHOOOHOHOHOHOOOOOOOHOOOHOOOOOOOHOHOHOOOHOHOOOHOHOOOHOOOHOOOOOOOOOHOOOHOOOOOOOHOHOOOHOOOOOH
HHOHHHOHHHOHHHOHOHOHOHOHHHHHOHOHHHHHHHHHOHHHOHOHHHOHHHOHOHHHHHHHOHHHHHHHHHOHOHHHOHHHHHHHHHOHOHOHHHHH
OOOHOOOHOOOHOOOHOHOOOHOOOOOHOOOHOOOHOOOHOOOHOOOHOOOHOHOOOHOOOOOHOOOOOOOOOHOHOHOOOHOOOOOOOOOHOHOOOHOH
OHHHOHHHHHHHOHOHOHHHOHHHHHOHHHOHOHOHOHOHHHOHHHOHOHHHOHHHOHOHHHOHHHHHHHHHOHOHOHHHHHOHHHHHHHHHOHHHOHOH
OHOOOHOOOHOOOHOHOOOHOHOOOHOHOOOHOHOOOHOOOHOOOHOHOHOHOOOOOOOHOOOOOOOOOOOOOHOHOOOOOOOHOOOOOOOHOHOOOHOH
OHOHHHOHOHOHHHOHHHOHOHHHOHOHHHOHOHHHHHHHOHHHOHHHOHOHOHHHHHHHHHHHHHHHHHHHHHOHOHHHHHHHHHHHOHOHOHHHOHOH
OHOHOOOHOOOHOHOHOHOOOHOOOHOOOHOHOHOOOOOHOOOHOOOOOHOOOOOHOOOOOOOHOOOOOOOOOHOHOOOOOOOOOOOOOHOHOOOHOHOH
OHOHOHHHHHHHOHOHOHHHHHOHHHHHOHOHOHHHHHOHHHOHHHHHHHHHHHHHOHHHHHOHOHHHHHHHOHOHOHHHHHHHHHHHHHOHHHOHOHOH
OOOHOHOHOOOOOOOHOOOHOOOHOOOOOHOHOHOOOOOOOHOOOOOOOOOOOOOOOHOOOHOOOHOOOOOHOOOHOHOOOHOHOOOOOHOHOOOHOOOH
OHHHOHOHOHHHHHHHOHOHOHOHOHHHHHOHOHOHHHHHHHHHHHHHHHHHHHHHHHOHOHHHHHOHOHOHHHHHHHOHOHOHOHHHOHOHOHHHHHHH
OHOOOHOOOHOHOOOOOHOHOHOHOHOOOOOHOHOOOOOOOOOOOOOOOOOOOOOOOOOHOHOOOHOHOHOHOOOOOHOHOHOOOHOOOHOHOOOOOOOH
OHOHHHOHHHOHOHOHHHOHOHHHOHHHHHOHOHOHHHHHHHHHHHHHOHHHHHOHHHHHOHOHHHOHOHOHOHHHOHOHOHHHHHOHHHOHHHHHHHOH
OOOHOHOHOOOOOHOOOHOOOHOOOHOOOHOHOHOOOOOOOHOOOOOHOHOHOOOHOHOOOHOOOHOHOHOOOHOOOHOHOHOOOHOHOOOHOOOOOHOH
HHHHOHOHHHOHHHHHOHHHHHOHHHOHOHHHOHHHHHHHOHOHHHOHOHOHOHHHOHOHHHOHOHOHOHHHHHOHHHOHOHOHOHOHOHHHOHHHOHOH
OOOOOHOOOHOHOOOHOOOOOHOOOOOHOOOOOHOHOOOOOHOHOHOHOOOHOHOHOOOHOOOHOOOHOHOOOOOOOOOHOOOHOHOOOOOHOOOHOHOH
HHHHOHHHOHOHOHOHHHOHOHHHHHHHHHHHHHOHOHHHHHOHOHOHHHOHOHOHOHHHHHOHHHHHOHHHHHHHHHHHHHHHOHHHHHHHHHOHOHOH
OOOOOHOHOHOHOHOOOHOHOOOHOHOOOOOOOHOOOOOOOHOHOHOOOHOHOHOOOHOOOHOOOHOHOHOOOOOHOOOHOOOHOHOOOOOHOOOHOOOH
OHHHOHOHOHOHOHHHOHHHOHOHOHOHOHHHOHHHHHHHHHOHOHHHOHOHOHOHHHOHOHHHOHOHOHOHHHOHOHOHOHHHOHOHHHOHOHHHHHOH
OOOHOOOHOHOHOOOHOOOOOHOHOHOHOHOOOOOOOOOOOOOHOOOOOHOHOHOOOHOHOHOOOOOHOOOHOOOHOHOHOHOOOHOOOHOOOHOOOHOH
HHOHOHHHOHOHHHOHHHHHHHOHOHOHOHHHHHHHHHHHHHHHOHHHHHOHOHHHOHOHOHHHHHHHHHHHOHHHOHOHOHOHHHOHOHHHHHOHOHOH
OOOHOHOOOHOHOOOHOOOHOOOHOOOHOOOOOHOOOOOHOOOHOHOOOOOHOOOHOHOHOOOHOOOOOOOOOHOOOHOOOHOOOHOHOHOOOOOHOHOH
OHHHHHOHHHOHOHHHOHOHOHHHHHOHHHHHOHOHOHOHOHHHOHHHHHOHHHOHOHOHHHOHOHHHHHHHHHOHHHHHHHHHOHOHOHHHOHHHHHOH
OHOOOOOHOOOHOOOHOHOOOHOOOHOOOOOHOHOHOHOOOHOOOHOOOHOHOOOHOHOOOHOOOHOOOOOOOHOOOOOOOOOOOHOHOOOHOHOOOHOH
OHOHHHHHHHHHHHOHOHHHHHOHOHHHHHHHOHOHOHHHHHOHHHOHOHHHOHHHOHHHOHHHHHOHOHHHHHOHHHHHHHHHHHHHHHOHOHOHOHOH
OOOOOOOOOOOOOOOHOOOOOOOHOOOOOOOOOHOHOOOOOOOOOOOHOOOOOHOOOOOOOHOOOOOHOOOOOOOOOOOOOOOOOOOOOOOHOOOHOOOH
HHHHHHHHHHHHHHHHHHHHHHHHHHHHHHHHHHHHHHHHHHHHHHHHHHHHHHHHHHHHHHHHHHHHHHHHHHHHHHHHHHHHHHHHHHHHHHHHHHHH
