OOOHOOOOOOOOOOOOOHOOOOOHOOOOOOOHOOOOOOOOOHOHOOOOOOOOOOOOOOOHOHOHOOOOOOOOOOOOOHOOOHOOOOOOOOOHOOOOOOOH
OHOHOHOHHHHHHHHHHHOHHHOHOHHHOHOHOHHHOHHHOHOHOHOHHHHHHHHHHHOHOHOHHHHHOHOHHHHHOHHHOHOHOHHHHHOHOHHHHHOH
OHOHOHOHOOOOOOOHOOOHOOOHOHOHOHOHOHOHOHOOOHOHOHOHOOOOOHOOOHOHOHOHOHOOOHOHOOOHOOOHOOOHOOOHOOOHOOOOOHOH
HHOHOHOHOHHHHHOHOHHHOHHHOHOHOHHHOHOHOHOHHHOHOHOHOHHHOHOHOHOHOHOHOHOHHHHHOHOHHHOHHHHHOHOHHHOHHHHHHHOH
OOOHOHOOOHOOOHOOOHOHOOOOOHOHOOOHOOOHOHOOOOOHOHOHOHOHOHOHOOOOOHOOOHOOOOOOOHOHOOOHOOOHOHOOOHOOOOOOOOOH
OHOHOHHHHHOHOHHHHHOHHHHHHHOHHHOHOHHHOHHHHHOHOHOHOHOHOHHHHHOHHHHHOHHHHHHHHHOHOHHHOHOHHHHHOHHHHHHHHHHH
OHOHOHOOOOOHOOOHOOOOOOOOOHOOOHOOOHOOOHOOOHOHOHOOOHOHOOOOOHOHOOOHOOOHOOOOOHOHOOOOOHOHOOOHOHOOOOOOOOOH
OHHHOHOHOHHHHHOHOHHHOHHHOHHHOHHHHHOHHHOHHHOHOHHHHHOHHHHHOHOHOHOHHHOHOHHHHHOHHHHHHHOHOHOHOHOHHHHHHHOH
OOOOOHOHOHOOOHOHOOOHOOOHOOOHOOOHOOOHOOOHOOOHOOOHOHOOOOOHOHOHOHOOOOOOOHOOOHOHOOOHOOOOOHOOOHOHOOOHOOOH
OHHHHHHHOHOHHHOHHHOHHHOHHHOHOHOHOHHHOHHHOHHHHHOHOHOHOHOHOHHHOHHHHHHHHHOHOHOHOHOHHHHHHHOHHHOHOHOHOHOH
OHOOOOOHOHOOOHOOOHOOOHOHOOOOOHOHOHOOOHOOOHOOOHOHOOOHOHOHOOOOOHOOOOOHOOOHOHOHOHOHOOOOOHOHOOOHOHOOOHOH
OHHHOHOHOHHHOHHHOHOHHHOHOHHHHHHHOHOHOHOHHHOHOHOHHHHHOHOHHHHHHHOHHHHHOHHHOHOHOHOHOHHHOHOHOHHHOHHHHHOH
OOOOOHOOOHOOOOOHOHOHOOOHOHOOOHOOOHOHOHOOOHOHOHOOOOOHOHOHOOOOOOOHOOOOOHOHOOOHOHOHOHOOOHOHOOOHOOOHOOOH
HHHHHHHHHHOHHHOHOHOHOHHHHHOHOHOHHHOHHHHHOHHHOHHHHHOHOHHHOHOHHHHHOHHHHHOHOHHHOHOHOHOHHHOHHHOHHHOHOHHH
OOOOOOOOOHOOOHOHOHOHOHOOOOOHOHOOOHOOOOOHOOOHOOOOOHOHOOOOOHOOOOOHOOOHOOOHOHOOOHOOOHOOOHOOOHOHOOOHOOOH
OHOHHHHHHHOHOHOHOHHHOHOHHHHHOHHHOHOHOHOHHHOHOHHHOHOHHHHHHHHHHHOHHHOHOHOHOHOHHHHHHHHHOHOHHHOHOHHHHHOH
OHOOOOOOOOOHOHOHOOOHOHOOOOOHOOOOOHOHOHOHOOOHOHOHOHOOOOOOOOOOOOOOOHOHOHOOOHOHOOOOOOOHOHOHOOOHOHOOOOOH
OHHHHHHHHHHHOHHHHHOHOHHHHHOHHHHHHHHHOHOHOHHHOHOHOHHHHHHHHHHHHHHHOHOHHHOHHHOHOHHHHHOHOHOHOHHHOHHHOHHH
OHOOOOOOOOOHOOOOOHOHOOOOOHOOOHOOOOOHOHOHOHOOOOOHOOOOOHOOOHOOOOOHOHOOOHOHOHOHOOOHOOOHOHOHOOOHOOOHOHOH
OHHHOHHHHHOHHHHHOHOHOHOHHHHHOHHHOHOHOHOHOHOHHHHHHHOHOHOHHHOHHHOHOHHHOHOHOHOHHHOHOHOHOHOHHHOHHHOHOHOH
OHOOOHOOOHOOOHOHOOOHOHOOOOOHOOOHOHOOOHOHOHOHOOOOOOOHOHOHOOOHOHOOOHOHOHOOOHOOOHOHOHOHOHOOOHOHOHOHOHOH
OHOHHHHHOHHHOHOHHHHHHHHHOHOHHHOHOHHHHHOHOHHHOHHHHHHHOHOHOHHHOHHHHHOHOHHHHHHHOHHHOHOHOHHHHHOHOHOHOHOH
OOOHOOOOOOOHOHOOOOOOOOOHOHOOOHOHOOOHOOOHOHOOOHOOOOOOOHOHOOOHOOOOOOOHOOOOOOOHOHOOOHOHOOOOOOOHOHOHOOOH
HHHHHHOHHHOHOHOHOHHHHHOHOHHHHHOHOHOHHHHHOHOHHHOHHHHHHHOHHHOHOHOHHHOHHHHHHHOHOHOHHHOHHHHHHHHHOHOHHHHH
OOOOOOOHOOOHOHOHOHOOOHOOOHOOOOOHOHOOOHOOOHOOOHOHOOOOOHOOOHOHOHOHOOOOOOOOOHOOOHOHOOOOOHOOOOOOOHOOOOOH
OHHHHHHHOHHHOHHHOHOHHHHHOHOHHHHHOHHHOHOHHHHHOHOHOHOHOHOHHHOHOHOHOHHHHHHHHHHHHHOHHHOHHHOHHHHHOHHHHHOH
OOOOOOOHOOOHOHOOOHOHOOOOOHOOOHOOOOOHOHOOOOOHOHOHOHOHOHOHOOOHOHOHOHOOOOOOOOOOOHOOOHOHOOOHOOOHOOOHOOOH
OHHHHHOHHHHHOHOHHHOHOHHHHHHHOHHHHHOHOHHHHHOHOHOHHHOHOHOHOHHHOHOHHHOHHHHHHHHHOHOHOHHHOHHHHHOHOHOHOHOH
OHOOOHOOOOOHOOOHOOOHOHOOOOOHOOOHOOOHOOOOOHOOOHOOOHOHOOOHOOOHOHOOOHOHOOOOOOOHOOOHOHOOOHOOOOOHOHOHOHOH
OHOHOHHHHHOHHHHHHHOHOHOHOHHHHHOHOHHHHHOHHHHHHHHHOHOHHHHHHHOHHHOHOHOHHHHHHHOHHHHHOHOHHHOHHHHHOHOHOHOH
OOOHOHOOOHOHOOOOOOOHOHOHOHOOOOOHOOOHOHOOOOOOOOOHOHOOOHOOOHOOOHOHOOOHOOOOOHOOOOOHOOOOOOOHOOOOOHOHOHOH
OHHHHHOHOHOHOHHHOHHHOHHHOHOHHHHHHHOHOHHHHHOHHHHHOHHHOHOHOHHHOHHHHHOHOHHHOHOHHHOHHHHHHHHHOHHHHHOHOHOH
OHOOOOOHOHOOOOOHOOOOOOOOOHOOOOOHOHOHOOOOOHOOOOOHOOOHOOOHOOOHOOOOOHOOOHOOOOOHOHOOOHOOOOOHOHOOOHOHOHOH
OHOHHHHHOHHHHHOHHHHHHHHHHHHHHHOHOHOHOHHHOHHHHHOHHHOHHHHHHHOHHHHHOHHHHHHHHHHHOHOHHHOHHHOHOHHHOHOHOHOH
OHOOOHOOOHOOOHOHOOOOOOOOOOOOOOOHOHOHOOOHOHOOOHOOOHOOOOOOOHOOOOOHOOOHOOOHOOOOOOOHOOOHOHOOOHOOOHOHOHOH
OHHHOHOHHHOHOHOHOHHHHHHHHHHHHHHHOHOHOHOHOHOHOHHHOHHHHHHHOHOHHHHHHHOHOHOHHHHHHHHHOHHHOHHHHHOHHHOHOHHH
OHOHOHOHOOOHOHOHOHOOOOOOOOOHOOOOOHOHOHOHOOOHOOOHOHOOOOOHOHOOOOOOOHOHOHOHOOOHOOOOOHOOOOOOOOOHOOOHOOOH
OHOHOHOHHHOHOHHHOHOHHHHHHHOHOHHHOHOHOHOHHHHHHHOHOHOHOHHHOHHHHHOHOHOHOHOHOHOHOHHHHHOHOHHHOHHHOHHHHHOH
OOOHOHOOOOOHOOOOOHOHOOOOOHOHOOOHOOOHOHOOOHOOOOOHOOOHOHOOOHOOOOOHOHOHOHOOOHOHOHOHOOOHOOOHOHOOOHOOOOOH
HHOHOHHHOHHHHHHHOHOHOHHHOHOHHHOHHHHHHHOHOHHHHHHHHHHHOHOHHHOHHHOHHHOHOHHHHHOHOHOHOHHHHHOHHHOHHHOHHHOH
OHOHOOOHOHOOOOOHOHOHOHOHOHOOOHOOOOOOOHOHOOOHOOOHOOOOOHOOOHOHOHOHOOOHOHOOOHOHOHOHOOOHOHOOOOOHOHOHOOOH
OHOHHHOHHHOHHHOHHHOHOHOHOHHHOHHHHHHHOHOHHHOHOHOHOHHHHHHHOHOHOHOHOHHHOHOHOHOHOHOHHHOHOHHHHHHHOHOHOHHH
OHOHOOOHOOOHOHOOOHOOOHOHOHOOOHOHOOOOOHOOOHOOOHOHOOOOOOOHOOOHOOOHOHOOOHOHOHOOOHOOOHOOOHOHOOOOOHOHOOOH
OHOHOHHHOHHHOHHHOHHHHHOHOHOHHHOHOHHHHHHHOHHHHHOHHHHHHHOHHHHHOHHHOHOHOHOHOHHHHHOHHHHHOHOHOHOHHHOHHHOH
OHOHOOOHOHOOOOOHOHOOOOOHOHOHOOOOOOOOOOOHOHOOOHOOOHOOOHOOOOOOOHOOOHOHOOOHOOOOOHOHOOOOOHOOOHOOOHOOOHOH
OHOHHHOHOHOHOHOHOHOHOHHHOHOHHHOHHHHHHHOHOHOHOHOHOHHHOHHHHHHHHHOHHHHHHHHHHHOHOHOHOHHHHHHHHHOHOHHHOHOH
OHOHOHOOOHOHOHOHOHOHOOOOOHOOOHOHOOOHOHOHOHOHOOOHOOOHOOOOOHOOOOOHOOOOOOOOOHOHOHOOOOOOOOOOOHOHOOOHOHOH
OHOHOHHHHHHHOHOHOHOHHHHHHHHHOHHHOHOHOHOHHHOHHHHHHHOHOHHHOHOHHHHHHHOHHHHHOHHHOHHHHHHHHHHHOHOHHHOHOHHH
OHOOOOOOOOOHOHOHOHOOOHOOOOOHOOOOOHOHOHOHOOOHOOOOOHOOOHOOOHOHOOOOOHOOOHOHOHOOOHOOOOOOOHOOOHOHOOOHOOOH
OHHHHHHHHHOHOHOHOHHHOHOHOHHHHHHHHHOHOHOHOHHHHHOHHHHHHHOHHHOHOHHHOHHHOHOHOHOHHHOHHHHHOHOHHHHHOHHHHHOH
OOOHOOOOOHOHOHOHOOOHOOOHOHOOOOOHOOOHOHOOOHOOOOOHOOOOOHOHOHOHOHOHOOOOOHOHOHOHOOOHOOOHOHOOOOOOOHOOOOOH
OHOHOHHHOHOHOHOHHHOHOHHHHHOHHHOHOHHHOHHHHHOHHHHHOHOHHHOHOHOHOHOHHHHHHHOHOHOHOHHHOHOHOHHHHHOHHHOHHHOH
OHOHOOOHOOOHOHOHOOOHOHOOOOOHOHOOOHOOOHOOOOOOOHOOOHOOOOOHOHOOOHOOOOOHOOOHOHOOOHOOOHOOOHOOOOOHOOOHOOOH
OHOHHHOHHHHHOHOHOHHHOHOHHHHHOHHHHHOHOHHHHHHHOHOHHHHHHHHHOHHHHHHHOHOHHHOHOHOHHHOHHHHHHHOHHHHHOHHHOHHH
OHOHOOOHOOOOOHOHOOOOOHOHOHOOOOOHOOOHOOOOOOOOOHOHOOOOOOOOOHOOOOOOOHOOOOOHOHOOOHOOOOOHOOOHOHOOOHOOOHOH
OHOHOHHHOHOHHHHHHHHHHHOHOHOHOHHHOHOHOHHHHHHHHHOHOHHHHHHHOHHHOHHHHHHHHHHHOHHHOHHHHHOHOHHHOHOHHHOHHHOH
OHOHOOOHOHOOOOOHOOOOOHOHOOOHOOOOOHOHOHOOOOOOOHOHOHOOOHOOOHOOOHOOOOOOOOOOOHOOOOOHOOOHOOOOOHOOOHOOOOOH
OHHHHHOHOHHHHHOHOHHHOHOHHHHHHHHHOHOHHHOHHHHHOHOHOHOHOHOHHHOHHHOHHHHHHHHHHHHHHHOHOHHHHHHHHHHHOHHHHHHH
OHOOOOOHOOOOOHOOOOOHOHOOOHOOOOOHOHOOOHOHOOOHOOOHOHOHOHOHOOOOOHOOOOOOOHOOOOOHOOOHOOOOOOOOOOOHOOOOOOOH
OHOHHHHHHHHHOHHHHHHHOHHHOHOHHHOHHHHHOHOHHHOHHHHHOHOHHHOHOHHHOHHHHHHHOHOHHHOHOHHHHHHHHHHHOHHHHHHHHHOH
OOOHOOOOOHOOOHOOOOOOOOOHOHOHOHOOOOOHOOOHOOOHOOOOOHOOOOOHOOOHOOOOOHOHOOOHOHOHOOOHOOOOOOOHOHOOOOOOOHOH
OHHHHHOHHHOHHHOHHHHHOHHHOHOHOHHHHHOHHHOHOHHHOHOHHHOHHHHHHHOHOHHHOHOHHHHHOHOHHHOHOHHHHHOHOHOHOHHHOHOH
OOOOOHOOOOOOOHOOOHOOOHOOOHOOOHOOOHOOOHOHOOOOOHOOOHOOOOOHOHOHOOOHOHOOOHOOOOOHOOOHOHOOOHOHOHOHOHOHOHOH
HHHHOHOHHHHHHHOHOHOHHHOHHHHHOHOHHHHHOHOHHHHHHHHHOHHHHHOHOHOHHHOHOHOHHHOHHHHHHHHHOHOHOHOHOHOHOHOHOHOH
OHOOOHOOOHOOOHOHOHOOOHOOOOOOOHOOOOOHOHOOOOOOOOOHOHOOOHOHOOOOOHOHOHOHOOOHOOOOOOOOOHOHOHOHOOOHOHOOOHOH
OHOHHHHHHHOHOHOHOHHHHHHHHHHHHHOHHHOHOHHHHHHHHHOHOHOHHHOHHHHHOHOHOHOHOHHHOHOHHHHHHHHHOHOHHHHHOHOHHHOH
OHOOOOOOOOOHOHOHOOOOOOOOOHOOOOOOOHOHOHOOOOOOOHOOOHOOOHOOOHOHOHOHOOOHOHOOOHOHOOOOOOOHOOOOOHOOOHOOOHOH
OHHHHHHHHHHHOHOHHHHHOHHHOHHHHHOHHHOHOHHHOHOHHHHHHHHHOHHHOHOHOHOHHHOHOHOHOHOHOHHHHHOHHHHHOHOHHHOHHHOH
OOOOOHOOOHOOOHOOOHOOOHOHOOOOOHOHOOOHOOOHOHOOOOOHOOOOOHOOOHOOOHOOOHOHOHOHOHOHOOOHOHOHOOOHOOOHOOOHOOOH
OHHHOHOHOHOHHHOHHHOHHHOHHHHHOHHHOHOHHHOHHHOHHHOHOHOHHHOHHHOHHHHHOHOHOHOHOHOHHHOHOHOHOHOHHHHHHHHHOHOH
OOOHOHOHOOOHOOOHOOOHOHOOOOOOOHOOOHOOOHOOOHOHOHOHOHOOOHOHOOOHOOOOOHOHOHOHOHOOOHOHOHOHOHOOOOOOOHOOOHOH
OHOHHHOHHHHHHHHHOHHHOHOHHHHHHHOHOHHHHHHHOHOHOHOHOHHHOHOHOHHHOHHHHHHHOHHHOHHHOHOHOHOHOHHHHHHHOHOHHHHH
OHOOOOOHOOOOOOOHOHOHOOOHOOOOOHOHOHOOOOOOOHOOOHOOOHOOOHOHOOOHOHOOOOOHOHOOOHOOOHOOOHOHOHOOOHOOOHOOOOOH
OHHHHHHHHHOHHHOHOHOHOHHHOHHHOHOHHHOHOHHHHHOHHHHHHHOHOHOHHHHHOHOHHHOHOHOHHHHHHHHHOHOHOHOHOHOHHHHHHHOH
OHOOOOOOOOOHOOOHOHOHOHOOOOOHOOOHOOOHOHOOOHOHOOOOOHOHOHOHOOOHOOOOOHOHOHOHOOOOOHOOOHOOOHOHOOOHOOOOOHOH
OHHHHHOHOHHHOHHHOHOHOHOHHHOHHHOHOHHHOHOHOHHHOHHHOHOHOHOHOHOHHHHHHHOHOHOHOHHHOHOHHHHHHHOHHHOHOHHHOHOH
OOOOOHOHOHOOOHOOOHOOOHOHOHOOOHOHOHOOOHOHOOOHOHOOOOOHOHOHOHOOOHOOOOOHOHOOOHOOOHOHOOOOOHOHOOOHOHOOOHOH
HHHHOHOHOHOHHHHHOHOHHHOHOHHHOHOHOHHHHHOHHHOHOHHHHHHHOHOHOHHHOHOHHHOHOHOHHHOHOHOHOHHHHHHHHHOHOHOHHHOH
OOOHOHOHOHOOOOOOOHOOOHOOOHOOOHOHOOOOOHOHOHOHOOOHOOOOOHOOOHOHOHOHOOOHOHOHOOOHOHOOOHOOOHOOOHOHOHOOOHOH
HHOHOHHHOHHHHHHHHHHHOHOHHHOHHHOHHHHHOHOHOHOHOHOHHHOHHHHHHHOHOHOHOHHHOHOHOHHHHHHHOHOHOHHHOHHHOHHHOHOH
OOOHOHOOOHOHOOOOOOOHOHOHOOOHOOOHOOOHOHOHOHOHOHOOOHOHOOOOOHOOOHOHOHOOOHOHOOOOOHOOOHOHOOOOOHOOOHOHOOOH
OHHHOHOHHHOHOHHHOHHHOHHHOHHHOHHHOHOHOHOHOHOHOHHHOHHHOHOHHHOHHHOHHHOHHHHHHHHHOHOHHHOHHHHHOHOHHHOHHHHH
OOOHOOOHOHOOOOOHOOOHOOOOOHOHOOOHOHOHOHOHOHOHOOOHOOOOOHOOOOOHOOOOOHOHOOOOOOOHOHOHOOOHOOOOOHOOOHOOOOOH
OHOHHHHHOHOHHHHHHHOHHHHHHHOHHHOHOHOHOHOHOHOHHHHHHHOHHHHHHHHHOHHHOHOHOHHHHHOHOHOHOHHHOHHHHHHHOHHHOHOH
OHOOOOOOOHOHOOOOOOOHOOOOOHOOOHOOOHOHOHOHOHOHOOOOOHOHOOOOOOOHOHOHOHOOOHOOOOOHOOOHOOOHOOOHOOOOSOOOOHOH
OHHHHHHHOHOHOHHHHHHHOHOHOHOHOHHHHHOHOHOHOHOHOHHHOHOHHHOHOHOHOHOHOHHHHHOHHHHHHHHHHHOHHHOHHHHHGHHHHHHH
OHOOOOOHOOOHOOOOOOOHOHOHOOOHOOOHOOOHOOOOOHOOOHOOOHOOOHOHOHOHOOOHOOOOOHOHOHOOOOOOOOOHOOOOOOOHOOOOOOOH
OHHHHHOHHHHHHHHHHHOHOHOHHHHHHHOHOHHHHHHHOHHHHHOHHHHHOHHHOHOHHHHHHHOHHHOHOHOHOHHHHHHHHHHHHHOHOHHHHHOH
OHOOOHOOOHOOOOOOOHOOOHOOOOOOOHOHOOOHOOOHOHOOOOOHOOOHOOOOOHOOOOOOOOOHOOOHOHOHOOOOOHOOOOOOOHOHOOOHOOOH
OHOHOHOHOHOHHHOHHHHHHHHHHHHHOHHHOHHHOHOHHHOHHHHHOHOHHHOHHHHHHHHHHHHHOHHHOHOHHHHHOHOHHHHHOHOHHHOHOHHH
OOOHOOOHOHOOOHOOOOOOOHOOOHOHOOOOOHOOOHOOOHOHOOOOOHOOOOOHOOOHOOOHOOOOOHOOOHOHOOOHOOOHOOOHOHOOOHOHOOOH
HHHHHHHHOHHHHHHHHHOHOHOHOHOHHHHHHHOHHHHHOHOHHHHHHHOHHHHHOHOHOHOHOHHHHHOHOHOHOHOHHHHHHHOHOHHHOHHHHHOH
OOOOOOOHOOOOOOOOOOOHOHOHOOOHOOOHOOOHOOOHOOOHOOOOOHOHOOOOOHOHOHOHOOOOOHOHOHOOOHOHOOOOOHOHOOOHOOOOOHOH
OHHHOHHHHHHHHHHHHHHHOHOHHHOHOHOHOHHHHHOHHHOHOHHHOHOHOHHHHHOHOHOHHHHHOHOHOHHHHHOHOHHHOHOHHHOHHHHHOHOH
OHOHOOOOOOOOOOOOOOOHOOOHOHOOOHOHOHOOOHOOOOOHOHOHOHOHOOOHOHOOOHOOOHOOOHOHOOOOOHOHOOOHOOOOOHOHOOOHOOOH
OHOHHHHHHHHHHHHHHHOHHHHHOHHHHHOHOHOHOHOHHHHHOHOHOHOHHHOHOHHHHHHHOHOHHHOHHHHHOHOHHHOHHHHHHHOHHHOHHHOH
OOOOOHOOOOOOOOOHOHOOOHOOOOOHOOOHOHOHOHOHOOOHOHOHOHOOOHOHOOOOOHOOOHOHOOOHOOOHOOOOOOOHOOOHOOOHOOOHOOOH
HHHHOHHHOHHHHHOHOHHHOHOHOHHHOHHHOHOHOHHHOHOHOHOHOHHHHHOHHHHHOHOHHHOHHHHHOHOHHHHHHHHHOHOHOHHHOHHHOHHH
OOOOOOOOOHOOOOOOOOOHOOOHOOOOOOOHOOOHOOOOOHOOOOOHOOOOOOOOOOOOOHOOOOOOOOOOOHOOOOOOOOOOOHOOOHOOOOOOOOOH
HHHHHHHHHHHHHHHHHHHHHHHHHHHHHHHHHHHHHHHHHHHHHHHHHHHHHHHHHHHHHHHHHHHHHHHHHHHHHHHHHHHHHHHHHHHHHHHHHHHH
