OOOOOOOOOOOOOOOOOOOHOOOOOOOOOOOOOHOOOOOOOOOOOOOOOHOOOOOOOOOOOOOHOOOOOOOOOHOOOOOOOOOOOOOOOOOOOHOOOOOH
OHHHHHHHHHHHHHHHOHOHOHHHHHHHHHHHOHOHHHOHHHHHHHHHOHOHHHHHOHHHHHOHHHOHHHHHOHOHHHHHHHHHHHHHHHHHOHOHHHOH
OHOOOOOHOOOOOOOOOHOOOHOOOHOOOHOOOHOOOHOHOOOHOOOHOHOOOOOHOOOOOHOHOOOHOHOOOOOHOOOOOHOOOOOHOOOHOHOHOOOH
OHHHOHOHOHHHHHHHHHHHHHOHHHOHOHOHHHOHOHOHOHOHOHOHOHHHHHOHHHHHOHOHOHHHOHOHHHHHOHHHOHHHOHOHHHOHOHOHOHHH
OOOHOHOHOHOOOOOOOOOOOOOOOOOHOHOOOHOHOHOHOHOOOHOHOOOOOHOOOHOOOHOOOHOOOOOOOHOOOHOHOHOOOHOOOOOHOHOHOOOH
HHOHOHOHOHHHOHHHHHHHHHHHHHHHOHHHOHHHOHOHOHHHHHOHHHHHHHOHHHOHHHOHHHHHHHOHHHOHHHOHOHOHOHHHHHHHOHOHHHOH
OHOHOHOHOOOHOOOOOHOOOOOOOOOHOOOHOOOOOHOHOHOOOHOOOOOOOOOHOOOHOOOHOOOOOHOHOOOOOOOHOHOHOHOOOOOOOHOHOOOH
OHOHOHOHHHOHHHOHHHOHHHHHHHOHOHHHHHHHHHOHOHHHOHHHHHHHHHHHOHHHOHHHOHHHOHHHOHHHHHHHOHOHOHOHHHHHHHOHHHHH
OOOHOHOOOHOHOOOHOOOHOOOHOOOHOHOOOOOOOOOHOOOOOHOHOOOOOOOOOHOHOOOHOHOHOOOOOHOHOOOOOHOHOHOHOOOOOHOOOOOH
OHHHOHHHOHOHHHHHOHHHOHOHOHHHOHOHHHHHHOHHHHHHOHOHOHHHHHHHHHOHHHOHHHOHHHHHHHOHOHHHHHOHHHOHHHOHOHHHHHOH
OOOHOOOHOHOOOOOOOHOHOHOOOHOOOHOHOOOHOOOOOOOHOHOHOOOHOOOHOOOOOHOOOHOOOOOHOOOHOHOHOOOOOHOHOOOHOOOOOOOH
HHOHHHOHOHHHHHHHHHOHOHHHHHOHHHOHHHOHOHHHHHOHOHOHHHOHOHOHHHOHHHHHOHHHHHOHOHOHOHOHOHHHOHOHOHHHHHHHHHOH
OHOOOHOHOOOHOOOOOOOHOOOHOOOHOOOHOOOHOOOOOHOOOHOHOOOHOHOOOHOHOOOOOHOOOOOHOHOHOHOOOHOHOOOOOHOOOHOOOHOH
OHHHOHHHOHHHOHHHHHOHHHOHOHHHOHHHOHOHHHHHOHHHHHOHOHHHOHHHOHOHOHHHHHOHHHHHOHOHOHOHHHOHHHHHHHOHOHOHHHOH
OOOHOOOHOOOOOOOOOHOOOHOHOOOOOOOOOHOOOHOHOHOOOOOHOOOOOHOOOHOHOOOOOHOHOOOHOHOHOHOOOOOHOOOOOOOHOHOOOHOH
OHHHHHOHOHHHHHHHHHOHHHOHHHHHHHHHHHHHOHOHOHHHOHOHHHHHHHOHHHOHOHHHHHOHOHOHHHOHOHHHHHHHOOHHHHHHOHHHOHOH
OOOHOOOHOOOOOHOOOHOOOHOOOHOOOHOOOOOOOOOHOOOHOHOOOOOHOOOHOHOOOHOOOHOHOHOOOOOHOOOHOOOOOOOOOOOHOHOOOHOH
HHOHOHHHHHHHOHOHOHHHOHHHOHOHOHHHOHHHHHHHHHOHOHOHHHHHOHHHOHOHHHOHOHOHOHHHHHOHHHOHOHHHHHHHHHHHOHOHHHOH
OOOHOOOHOOOOOHOHOOOHOOOHOHOHOOOHOOOHOOOOOOOOOHOHOOOOOHOOOOOHOOOHOHOOOHOOOOOHOHOOOHOOOOOHOOOOOHOOOOOH
OHHHHHOHOHHHHHOHHHOHHHOHOHOHHHOHOHHHOHHHHHHHHHHHOHHHHHOHHHHHHHHHOHHHHHOHHHHHOHHHHHOHHHOHOHHHHHOHHHHH
OHOOOHOHOOOOOHOHOHOOOOOHOOOHOHOHOHOOOHOOOHOOOOOOOHOOOOOHOOOHOHOOOOOOOHOOOHOOOOOOOHOHOOOOOHOOOOOOOHOH
OHOHHHHHHHHHOHOHOHHHHHOHHHHHOHOHHHOHHHOHOHOHHHHHHHOHHHHHOHOHOHOHHHHHOHHHOHHHHHOHHHOHHHHHHHHHHHHHOHOH
OHOOOHOOOOOOOHOHOOOHOOOHOOOOOHOOOHOHOOOHOHOOOOOHOHOOOHOHOHOOOHOOOOOHOOOHOOOOOOOHOOOHOOOOOHOOOHOHOHOH
OHHHOHHHHHHHOHOHOHOHOHHHOHHHHHHHOHOHOHHHOHHHHHOHOHHHOHOHOHHHHHHHHHOHHHHHHHHHHHOHOHHHOHHHOHOHOHOHOHOH
OOOHOOOOOOOHOHOHOHOHOHOOOHOOOOOHOOOHOOOHOOOOOHOHOOOOOOOHOHOOOOOOOOOHOOOOOOOOOOOHOOOOOOOHOOOHOHOOOOOH
OHOHHHHHHHOHHHOHOHHHOHOHOHOHHHOHHHHHHHOHOHHHHHOHHHOHHHHHOHOHHHHHHHHHOHHHHHHHHHHHHHHHHHHHHHHHOHHHHHHH
OHOHOOOOOOOHOOOHOOOOOHOHOHOOOHOHOOOOOOOHOOOOOHOOOHOHOOOOOHOHOOOOOOOOOHOOOOOHOOOHOOOOOOOOOOOHOHOOOOOH
OHOHOHHHHHHHOHHHOHHHHHOHOHHHOHOHOHHHHHHHHHHHOHHHOHHHOHHHHHOHOHHHHHHHHHOHOHHHOHOHOHHHHHHHHHOHOHOHHHOH
OHOOOHOOOHOOOOOHOOOOOOOHOHOHOHOOOHOOOOOOOOOHOOOHOOOOOHOOOHOOOHOOOOOOOHOHOHOOOHOOOHOOOOOOOOOHOOOHOOOH
OHHHHHOHOHOHHHOHHHHHHHHHOHOHOHHHHHOHHHHHHHOHHHOHHHHHHHHHOHHHHHOHHHHHOHHHOHOHHHHHOHHHHHOHHHHHHHHHOHHH
OHOOOOOHOHOHOOOHOOOOOOOHOHOHOHOOOHOHOOOOOOOHOHOHOOOOOOOHOOOOOOOHOOOHOOOOOHOHOOOHOHOOOHOOOOOOOOOHOOOH
OHOHHHOHHHOHOHHHOHHHHHOHOHOHOHOHOHOHOHHHHHHHOHOHOHOHHHOHHHOHHHHHOHOHHHHHOHOHOHOHHHOHOHHHHHHHHHOHHHOH
OHOOOHOOOOOHOOOHOHOHOOOHOOOHOOOHOOOHOOOHOOOOOHOOOHOOOHOOOOOHOHOOOHOHOOOOOHOOOHOOOOOHOHOOOOOOOHOOOOOH
OHHHOHHHHHHHHHOHOHOHOHHHHHHHHHOHHHHHHHOHHHOHHHHHHHHHOHHHHHHHOHOHHHOHOHHHHHHHHHHHOHHHOHHHHHHHOHHHHHOH
OOOHOHOOOHOOOHOOOOOHOHOOOOOOOOOHOOOOOHHOOHOOOOOHOOOOOHOHOOOOOOOHOOOHOOOOOOOHOOOHOOOHOOOHOOOOOOOHOOOH
HHOHOHOHOHOHOHHHHHHHOHOHHHHHHHHHOHHHOHHHOHHHOHOHOHHHHHOHOHHHHHHHOHOHHHHHOHHHOHOHHHHHOHOHOHOHHHHHOHHH
OHOHOHOHOOOHOHOOOHOOOHOOOHOOOHOOOHOHOOOHOOOHOHOHOOOOOHOOOOOHOOOOOHOOOOOHOHOOOHOOOOOHOHOHOHOHOOOOOHOH
OHOHOHOHHHHHOHOHOHOHHHHHOHOHOHOHHHOHHHOHHHOHHHOHHHHHOHHHHHOHOHOHHHHHOHHHOHOHHHHHHHOHHHOHOHHHOHHHHHOH
OHOHOHOOOHOHOOOHOHOOOOOOOOOHOHOHOOOOOHOOOHOOOOOHOOOHOOOHOOOHOHOHOOOHOHOOOHOHOOOOOHOHOOOHOOOOOHOOOOOH
OHOHHHHHOHOHHHHHOHOHHHHHOHHHHHOHHHHHOHHHOHHHHHOHOHOHHHOHHHHHOHHHOHOHHHOHHHOHHHHHOHOHOHHHOHHHHHOHHHOH
OHOOOHOOOHOOOOOHOHOHOOOHOHOOOOOHOOOOOHOOOHOOOHOHOHOOOHOOOOOHOOOOOHOOOOOHOHOOOOOHOOOHOHOOOHOOOOOHOOOH
OHHHOHOHHHHHHHOHOHHHOHOHHHOHHHHHOHHHHHOHHHOHHHOHOHHHOHHHOHOHHHHHHHHHHHOHOHHHHHOHOHHHOHOHHHOHOHHHHHHH
OOOOOHOHOOOOOHOHOOOHOHOOOHOHOOOOOHOOOHOHOOOHOOOHOOOHOOOHOHOOOOOOOHOOOHOOOOOHOHOHOOOOOHOOOHOHOOOHOOOH
OHHHHHOHOHHHOHOHHHOHOHHHOHOHHHOHHHOHOHOHOHHHOHHHHHOHHHOHOHHHHHHHOHOHOHHHHHOHOHOHHHHHHHHHOHOHHHOHOHOH
OOOHOHOOOHOOOHOOOHOHOOOHOOOHOOOHOOOHOOOHOOOOOOOHOHOHOHOHOOOOOOOHOOOHOHOOOHOOOHOOOHOOOOOHOHOOOHOHOHOH
HHOHOHOHHHOHHHOHHHOHHHOHHHHHOHOHOHHHHHHHHHHHHHOHOHOHOHOHHHHHHHHHHHHHOHOHOHHHOHHHOHHHHHOHOHHHOHOHOHOH
OOOHOOOHOOOHOOOHOOOHOOOHOOOOOHOHOHOOOOOOOOOOOHOOOHOHOOOOOOOOOOOHOOOOOHOHOOOHOOOHOOOHOOOHOHOOOHOOOHOH
OHHHOHHHOHHHOHHHOHHHOHHHOHHHOHOHOHHHHHOHOHHHOHHHHHOHHHHHHHHHHHOHOHHHHHOHHHOHHHOHHHOHOHHHOHOHHHHHHHOH
OOOHOHOOOHOOOOOHOOOHOOOHOOOHOHOHOOOOOHOHOHOHOOOOOHOOOHOOOOOOOHOHOOOOOHOHOOOHOHOHOOOHOHOOOHOOOOOOOHOH
HHOHOHOHHHOHHHOHHHOHOHOHHHOHOHHHHHHHOHHHOHOHHHHHOHHHOHHHHHOHHHOHHHHHOHOHOHHHOHOHOHHHOHOHHHHHHHHHOHOH
OHOHOHOHOHOHOOOHOOOHOHOHOHOHOOOOOOOHOOOOOHOOOOOHOOOOOHOOOHOHOOOOOOOOOHOHOHOOOOOHOHOOOHOHOOOOOOOHOHOH
OHOHOHOHOHOHOHHHOHHHHHOHOHOHHHOHHHHHHHHHHHOHHHHHOHHHHHOHOHOHOHHHHHHHHHOHOHHHHHHHOHOHHHOHHHHHOHHHOHOH
OOOHOHOHOOOHOOOHOOOHOOOHOOOHOHOOOOOOOOOOOHOOOOOOOHOOOOOHOHOHOHOHOOOOOOOHOOOOOOOOOHOHOOOHOOOHOOOOOHOH
OHHHOHOHHHHHOHOHHHOHOHHHOHHHOHHHHHHHHHHHOHOHHHHHHHOHHHHHOHOHOHOHOHHHHHHHHHHHHHHHHHOHOHHHOHOHOHHHHHOH
OOOHOHOHOOOHOHOOOHOOOHOHOHOOOOOHOOOOOHOOOHOOOHOOOHOOOOOHOHOHOOOHOHOHOOOOOOOOOOOHOOOOOHOOOHOHOHOOOOOH
HHOHOHOHOHOHHHHHOHHHHHOHOHHHOHHHOHHHOHOHOHHHOHOHOHHHHHOHOHOHHHOHOHOHOHHHOHOHHHHHOHHHHHOHHHOHHHOHHHOH
OOOHOHOOOHOHOOOOOOOOOOOHOOOOOHOOOHOHOOOHOHOHOOOHOOOHOHOHOHOOOOOHOHOOOOOHOHOHOOOOOHOOOOOHOHOOOHOOOHOH
OHHHHHHHHHOHOHOHHHHHHHOHHHHHOHOHHHOHHHHHOHOHHHHHHHOHOHOHOHHHHHHHOHOHHHHHOHOHOHHHHHHHOHHHOHHHOHOHOHOH
OOOOOHOOOOOHOHOHOOOOOHOHOOOHOHOHOOOOOOOHOOOOOOOOOHOOOHOHOHOOOHOOOHOHOOOOOHOHOHOHOOOOOHOOOOOHOHOHOHOH
HHHHOHOHHHHHOHHHOHHHOHOHOHOHOHOHOHHHOHOHHHHHHHHHOHHHOHOHOHOHOHOHHHHHOHHHHHHHOHOHOHOHHHHHOHOHOHHHOHOH
OOOHOHOHOOOOOHOOOHOHOHOHOHOHOHOHOOOHOHOHOOOOOHOOOOOHOHOHOOOHOOOHOOOOOHOOOOOHOHOHOHOHOOOHOHOOOOOOOHOH
OHHHOHOHOHHHOHOHHHOHOHOHOHOHOHOHHHHHOHHHOHHHOHOHHHHHOHOHHHHHHHHHHHOHHHOHHHHHHHOHOHOHOHOHHHHHHHHHHHOH
OOOOOHOHOOOHOHOOOHOHOHOHOHOOOHOOOOOHOHOOOHOHOOOHOOOHOHOOOOOOOHOOOOOHOOOHOOOOOOOOOHOOOHOOOOOOOOOOOHOH
OHHHHHOHHHHHOHHHOHOHOHHHOHHHHHHHHHOHOHOHHHOHHHHHOHOHOHHHHHHHOHOHHHHHOHHHHHHHHHOHHHHHHHHHHHHHHHHHOHOH
OOOHOOOOOHOOOOOHOHOHOOOOOHOOOOOHOOOHOHOOOHOOOHOOOHOOOHOOOOOHOHOOOOOHOHOOOOOOOHOHOOOOOOOHOOOHOOOHOHOH
HHOHHHHHOHOHHHOHOHOHHHHHHHOHHHOHOHHHOHHHOHHHOHOHHHHHHHOHHHOHOHHHHHOHOHHHOHHHOHOHOHHHHHOHOHOHOHHHOHOH
OHOOOOOOOHOHOHOHOOOOOOOOOHOHOOOHOHOOOOOHOOOHOHOOOHOOOOOOOHOHOOOOOHOOOHOOOHOHOHOOOHOOOHOOOHOOOOOHOHOH
OHHHHHHHHHOHOHOHHHHHHHHHOHOHOHHHOHOHHHHHHHOHOHHHOHHHHHHHOHHHHHOHOHOHHHOHHHOHOHHHHHOHOHHHHHOHHHOHOHOH
OHOOOOOOOOOHOOOOOOOHOOOOOHOHOOOOOHOOHOOOOOOOOHOOOHOOOOOOOHOOOHOHOHOHOOOHOOOOOOOOOHOHOHOOOOOOOOOHOHOH
OHOHHHHHOHOHHHHHHHHHOHHHHHOHHHHHHHOHHHHHHHHHOHOHHHOHHHHHOHOHOHHHOHOHOHHHHHHHHHHHOHOHOHHHHHHHHHOHOHHH
OHOOOOOHOHOHOOOOOOOHOOOOOHOHOOOHOHOHOOOOOOOHOHOHOOOHOOOHOHOHOOOOOHOHOOOOOHOOOHOHOOOHOOOHOOOHOOOHOOOH
OHHHOHHHOHOHOHHHHHOHHHHHOHOHOHOHOHOHOHHHHHOHHHOHOHOHOHHHOHOHHHHHHHOHHHHHOHOHOHOHHHHHHHOHOHOHHHHHHHOH
OOOHOHOOOHOHOHOHOOOOOOOHOHOOOHOHOHOHOOOHOHOHOOOHOHOHOOOOOHOOOHOOOHOOOOOHOOOHOHOOOHOOOHOHOHOHOOOOOOOH
OHHHOHOHHHOHOHOHOHHHHHOHOHHHHHOHOHOHHHOHOHOHOHHHOHOHOHHHHHHHOHHHOHHHHHOHOHHHOHHHOHOHOHOHOHOHOHHHHHOH
OOOOOHOHOOOHOHOHOOOOOHOHOHOHOOOHOHOOOHOHOHOOOHOOOHOHOOOHOOOHOHOOOOOOOHOHOOOHOOOHOOOHOOOHOHOOOHOOOOOH
OHHHHHOHHHHHOHOHHHHHOHHHOHOHOHHHOHOHHHOHOHHHHHHHHHOHHHOHHHOHOHOHHHHHHHOHHHHHHHOHOHHHHHHHOHHHOHHHOHHH
OHOOOHOOOOOOOOOOOHOHOOOOOOOHOOOHOOOHOOOHOOOOOOOOOOOHOHOOOHOHOHOHOOOHOHOOOOOOOOOHOOOOOOOHOOOOOOOHOOOH
OHOHOHHHHHHHHHHHOHOHHHHHHHHHHHOHOHHHOHHHOHHHHHHHHHHHOHHHOHOHOHOHOHOHHHHHHHHHHHHHHHHHHHOHHHHHOHOHHHOH
OHOHOHOOOOOOOOOHOHOOOOOOOHOOOHOHOOOHOOOOOHOOOOOOOOOOOOOHOOOHOHOOOHOHOOOOOHOOOOOOOOOOOHOOOOOHOHOOOHOH
OHHHOHOHHHHHHHOHOHOHHHHHHHOHOHOHHHOHHHHHHHHHOHHHHHHHOHHHOHHHOHOHHHOHOHHHOHOHHHHHHHOHHHHHHHOHHHOHOHHH
OOOOOHOOOHOOOOOHOOOHOOOOOOOHOHOHOOOHOOOOOOOHOHOOOHOHOHOOOHOOOHOOOHOOOOOHOOOOOHOOOHOOOOOOOHOOOHOHOOOH
HHHHOHHHOHOHHHHHHHHHOHHHHHHHOHOHOHHHOHHHHHOHOHOHOHOHOHOHHHOHHHHHHHOHHHHHHHHHHHOHOHHHHHOHOHHHOHOHHHOH
OOOOOHOOOHOOOHOOOOOOOHOOOOOHOOOHOHOOOHOOOHOOOHOHOHOOOHOHOHOHOOOOOHOOOHOOOOOOOOOHOOOOOHOHOHOOOHOOOHOH
OHHHHHOHHHHHOHHHOHHHHHOHHHHHHHHHOHOHHHOHOHHHOHOHOHHHHHOHOHOHOHHHOHHHHHOHHHHHHHHHHHHHOHOHHHOHHHHHHHOH
OHOOOHOOOHOOHOOHOOOHOOOHOOOOOOOHOOOHOOOHOHOOOHOHOOOOOOOHOHOOOHOOOHOOOOOHOOOOOOOHOOOHOHOOOHOOOOOHOOOH
OHHHOHHHOHHHHHOHHHOHOHHHOHHHHHOHHHHHOHHHHHOHHHOHHHHHHHHHOHHHHHOHOHOHHHHHOHHHHHHHOHOHOHOHOHHHHHOHOHOH
OOOOOHOHOHOOOHOOOOOHOOOOOOOHOOOOOHOOOOOOOOOHOHOOOOOOOHOOOOOOOHOHSHOHOOOOOHOOOOOOOHOOOHOHOOOOOHOHOHOH
HHHHOHOHOHOHOHHHHHHHOHHHHHOHOHHHOHOHHHHHHHHHOHHHHHHHOHOHHHHHHHOHGHOHOHHHOHOHHHHHHHHHHHHHHHHHOHOHOHHH
OOOHOOOHOOOHOOOOOOOHOHOOOHOHOHOOOHOHOOOOOOOOOOOOOOOHOHOOOOOHOOOHOOOHOOOHOHOHOOOOOOOOOOOOOOOHOHOHOOOH
OHOHHHHHHHHHHHHHHHOHOHOHOHOHOHHHHHOHHHOHOHHHHHHHHHOHOHHHHHOHOHOHOHHHOHOHHHOHHHHHHHHHHHOHHHOHOHOHHHOH
OHOOOOOHOOOOOOOOOOOHOHOHOHOHOOOOOHOOOHOHOHOOOOOOOHOHOOOHOOOHOHOOOHOOOHOOOHOOOHOOOOOOOHOHOOOOOHOHOOOH
OHHHHHOHOHHHHHHHHHHHHHOHOHOHHHHHOHHHOHOHHHOHHHHHOHOHHHOHOHHHOHHHHHOHHHHHOHHHOHOHHHHHOHOHHHHHHHOHOHHH
OOOHOOOOOHOOOOOOOOOOOOOHOHOHOOOOOHOOOHOOOHOOOHOOOHOOOHOHOHOOOHOOOOOHOOOHOHOOOHOHOOOOOOOHOOOOOOOHOOOH
OHOHHHHHHHOHHHHHHHHHHHHHOHHHOHHHHHOHHHHHOHHHOHOHHHHHOHOHOHOHHHOHHHHHOHOHOHOHHHOHHHHHHHOHOHHHHHHHHHOH
OHOOOOOOOHOHOOOHOOOOOHOHOOOHOOOOOOOOOOOOOHOOOHOOOHOOOHOOOHOHOOOHOOOOOHOOOHOHOOOHOOOHOOOHOHOOOOOHOOOH
OHHHHHHHOHOHOHOHOHHHOHOHHHOHHHHHOHHHHHHHHHOHHHHHOHHHHHOHHHOHOHHHOHHHHHHHHHOHOHHHOHOHHHHHOHOHHHOHOHHH
OHOOOOOHOHOOOHOHOHOOOHOHOOOHOOOHOOOHOOOOOHOOOOOHOOOOOHOHOOOHOOOHOOOOOOOOOOOHOOOHOHOHOOOOOHOHOHOHOOOH
OHOHHHOHOHHHHHOHOHOHHHOHOHHHOHOHHHHHOHHHOHHHHHOHHHHHOHOHOHHHHHOHHHHHHHHHHHHHOHOHOHOHOHOHHHOHOHOHHHOH
OOOHOOOHOOOOOOOOOHOOOOOHOOOOOHOOOOOOOOOHOOOOOOOOOOOHOOOHOOOOOOOHOOOOOOOOOOOOOHOOOHOOOOOOOOOHOOOOOOOH
HHHHHHHHHHHHHHHHHHHHHHHHHHHHHHHHHHHHHHHHHHHHHHHHHHHHHHHHHHHHHHHHHHHHHHHHHHHHHHHHHHHHHHHHHHHHHHHHHHHH
