OOOOOOOOOOOHOOOOOOOOOHOOOOOOOOOHOOOOOHOOOOOOOOOOOHOOOOOOOOOOOOOHOOOOOOOOOOOHOOOOOOOOOOOOOOOHOOOOOOOH
OHHHHHOHHHHHOHOHHHHHOHOHHHHHHHOHOHOHOHHHOHOHHHHHOHOHOHHHHHHHHHOHOHHHHHHHHHOHHHHHHHOHOHHHHHOHHHOHHHOH
OHOOOHOOOOOOOHOOOOOHOOOHOOOOOOOHOHOHOOOHOHOHOOOHOHOHOHOOOHOOOOOOOHOOOHOOOOOOOOOOOHOHOHOOOOOOOOOHOOOH
OHOHOHHHHHHHHHHHOHOHHHHHOHHHHHHHOHOHHHOHHHOHOHHHOHOHOHOHOHHHHHHHHHOHOHOHHHHHHHHHOHHHOHOHHHHHHHHHHHOH
OOOHOHOOOOOHOOOHOHOOOHOHOOOOOOOHOHOOOHOOOOOHOOOHOHOHOHOHOHOOOOOHOOOHOOOHOOOOOHOHOOOOOHOHOOOOOOOOOHOH
HHHHOHOHOHHHOHOHHHHHOHOHHHHHHHOHOHHHOHHHHHHHHHOHOHOHHHOHOHOHHHOHHHHHOHHHOHHHOHOHHHHHHHOHOHHHHHOHOHHH
OOOOOHOHOHOOOHOOOOOHOHOOOOOOOHOHOOOHOHOHOOOOOOOHOHOOOHOHOOOHOHOHOOOHOHOOOHOHOHOOOOOOOOOHOHOOOHOHOOOH
OHHHHHHHOHOHHHHHHHOHOHHHHHOHOHOHHHHHOHOHOHHHOHHHOHHHOHOHHHHHOHOHOHOHOHOHHHOHOHHHHHHHHHHHOHOHOHOHHHOH
OOOOOOOOOHOOOOOOOHOOOHOOOOOHOHOOOOOOOHOOOHOOOHOOOHOOOHOOOOOHOHOOOHOHOHOOOOOHOOOOOHOOOHOOOHOHOHOOOHOH
OHHHHHHHHHOHHHHHOHHHHHOHHHHHOHHHHHHHHHOHHHOHHHOHHHOHHHHHHHOHOHHHHHOHHHHHHHOHHHHHOHOHOHOHHHOHOHHHOHOH
OHOOOOOOOHOOOOOHOHOHOOOOOHOOOHOOOHOOOOOHOOOHOOOHOHOOOOOOOHOHOOOOOHOHOOOOOOOOOHOOOHOHOOOHOOOHOOOHOHOH
HHOHHHHHOHHHHHHHOHOHOHHHOHOHHHHHOHOHHHHHOHOHOHHHOHOHHHHHOHOHOHOHHHOHOHHHHHHHHHOHOHOHHHHHOHHHHHOHHHOH
OOOHOOOHOOOOOOOHOHOOOOOHOHOOOOOOOHOHOHOOOHOHOOOHOOOHOOOOOHOHOHOHOOOHOOOHOOOOOOOHOHOHOOOHOHOOOHOOOHOH
OHHHHHOHHHHHHHOHOHHHHHHHOHHHHHHHHHOHOHOHOHHHHHOHHHOHOHHHOHOHOHOHOHHHHHOHOHHHHHOHHHOHOHHHOHOHOHHHOHOH
OOOOOHOOOOOOOOOHOOOOOHOOOHOOOOOOOHOOOHOHOHOOOHOOOHOHOHOOOHOOOHOHOOOOOHOHOOOHOOOHOOOHOOOHOOOHOHOOOHOH
HHHHOHOHHHHHHHHHHHHHOHOHHHOHHHHHOHHHOHOHHHOHOHHHOHHHOHHHHHHHHHOHHHOHHHOHHHOHOHHHOHHHHHOHHHHHOHHHOHOH
OOOOOHOHOOOHOOOOOOOHOHOOOOOOOOOHOOOHOHOOOHOHOOOOOHOOOHOOOHOOOOOOOHOOOHOOOHOHOHOHOOOOOHOOOOOHOOOHOOOH
OHHHHHOHOHOHHHHHOHOHOHOHHHHHHHHHHHOHOHHHOHOHHHHHHHOHHHOHOHOHHHHHHHHHOHHHOHOHOHOHHHHHOHOHHHHHHHOHHHOH
OOOOOHOOOHOOOOOHOHOOOHOHOOOOOOOOOHOOOOOHOHOOOHOOOOOOOHOHOOOHOOOOOOOHOOOHOHOHOOOOOHOOOOOHOOOHOOOHOHOH
OHHHOHHHHHHHHHOHOHHHHHHHOHHHHHHHOHHHHHHHOHHHOHHHHHHHOHOHHHHHOHHHHHOHOHOHOHOHHHHHHHOHHHHHOHOHOHHHOHOH
OOOHOOOHOOOOOOOOOHOOOOOHOHOHOOOOOHOOOOOOOOOHOOOOOOOOOHOOOHOHOOOHOHOOOHOHOHOOOOOOOOOHOOOOOHOHOHOOOHOH
HHOHHHOHHHHHHHHHHHOHHHOHOHOHOHHHHHOHOHHHHHHHHHHHHHHHOHHHOHOHHHOHOHHHHHOHOHHHHHHHHHHHOHHHHHOHOHOHOHOH
OHOOOHOHOOOOOHOOOOOHOOOOOHOHOHOOOOOHOHOOOOOOOHOOOOOHOOOHOOOOOHOHOOOOOOOHOOOHOOOOOOOHOHOOOOOHOHOHOHOH
OHHHOHOHOHHHOHHHOHOHHHHHHHOHOHOHHHOHOHOHHHHHOHOHOHHHHHOHHHHHOHOHHHHHHHHHHHOHOHHHOHHHOHHHHHOHOHOHHHOH
OOOOOHOHOHOHOOOHOHOOOOOOOHOOOHOHOOOHOHOHOHOOOHOHOOOOOHOOOOOHOHOOOOOOOHOOOOOHOHOHOOOHOOOOOHOOOHOOOOOH
OHHHHHOHOHOHHHOHHHHHHHHHOHOHHHHHOHOHHHOHOHOHHHOHHHOHHHHHHHOHOHHHHHHHOHOHHHHHOHOHHHOHHHHHOHHHHHOHHHHH
OHOHOOOHOOOHOOOHOOOOOOOOOHOOOOOOOHOHOOOHOHOOOHOHOHOHOOOOOOOHOHOOOOOHOOOHOOOHOOOOOHOOOHOOOHOOOOOOOOOH
OHOHOHHHHHOHOHHHOHHHOHHHHHHHHHOHHHHHOHHHOHHHOHOHOHOHOHHHHHHHOHOHHHOHHHHHHHOHOHHHHHOHOHOHHHOHHHHHHHHH
OOOHOOOHOOOHOHOOOHOOOHOOOOOHOOOHOOOOOHOOOHOOOHOOOHOOOOOOOOOHOOOHOHOOOOOOOHOHOHOOOHOHOHOOOHOHOHOOOOOH
HHHHHHOHOHHHOHOHHHHHHHOHHHOHHHHHOHHHHHOHOHOHHHHHOHHHHHHHOHHHHHHHOHHHHHHHOHOHOHOHOHHHOHHHOHOHOHOHHHOH
OOOOOHOOOHOOOHOOOOOOOOOHOHOOOOOOOHOOOOOHOHOOOOOOOHOOOOOHOHOOOOOHOOOOOHOOOHOHOHOHOHOOOHOOOHOOOHOHOOOH
OHHHOHHHHHOHHHOHHHHHHHHHOHHHHHHHHHOHOHHHHHOHHHHHHHOHHHOHHHOHOHOHHHHHOHOHHHOHOHOHOHOHOHOHHHHHOHOHOHHH
OHOOOHOOOHOOOHOOOHOHOOOOOOOOOOOOOOOHOHOOOHOOOHOOOOOHOHOOOOOHOHOOOOOHOHOHOOOOOHOHOOOHOHOHOOOOOHOHOOOH
OHOHHHOHOHHHOHHHOHOHOHHHOHHHHHOHHHHHHHOHOHHHHHOHHHHHOHHHHHHHOHHHHHOHOHOHHHHHOHOHHHHHOHOHHHHHHHOHHHOH
OHOOOOOHOOOHOOOHOHOOOHOOOHOOOOOHOOOOOOOHOHOOOOOHOOOHOOOHOOOHOOOOOHOOOHOHOOOHOHOHOHOOOHOOOOOOOOOHOOOH
OHHHHHHHHHOHHHOHOHOHHHOHHHHHHHHHOHHHHHHHOHOHHHHHOHHHOHOHOHOHHHHHOHHHHHOHOHOHOHOHOHOHHHHHHHHHHHHHOHHH
OHOHOOOOOOOOOHOHOHOOOHOOOHOOOOOHOOOOOOOHOOOHOOOOOOOHOHOHOHOOOOOHOHOOOOOOOHOHOHOHOHOHOOOOOOOOOOOHOOOH
OHOHOHHHHHHHOHOHOHHHOHHHOHOHHHOHHHHHHHOHHHHHOHHHHHOHOHOHOHOHHHOHOHOHHHHHHHOHHHOHOHOHHHOHHHHHOHHHHHOH
OHOOOHOOOHOOOHOHOOOHOOOHOHOOOHOOOOOOOHOOOHOHOOOHOHOOOHOOOHOHOOOHOOOOOHOOOHOOOOOHOHOOOHOOOOOHOHOOOHOH
OHHHHHOHOHOHHHOHHHOHHHHHOHHHOHHHHHHHOHHHOHOHHHOHOHHHHHHHHHOHOHHHHHHHHHOHOHHHHHHHOHHHOHHHHHHHOHOHOHOH
OOOOOHOHOHOOOHOOOHOOOOOOOOOHOOOOOOOHOOOOOHOOOHOHOOOOOHOOOOOHOOOOOHOOOOOHOOOHOOOOOOOHOHOOOOOOOHOHOOOH
OHHHOHOHOHHHOHHHOHOHHHHHHHOHHHHHHHOHHHHHHHHHOHOHOHOHHHOHHHHHOHHHHHOHHHHHHHOHHHHHHHOHOHOHHHHHOHOHHHOH
OOOHOOOHOHOOOOOOOHOHOOOHOOOHOOOOOHOOOOOOOOOHOHOOOHOHOOOHOOOOOHOOOHOHOOOOOHOOOOOOOHOHOOOHOOOOOHOHOOOH
HHOHHHHHOHOHHHHHHHHHOHOHHHHHOHOHHHHHHHHHHHOHOHHHOHHHOHOHHHHHHHOHOHOHOHHHHHHHHHHHOHOHHHOHHHHHHHOHOHHH
OOOOOOOHOHOHOOOOOOOHOHOHOOOOOHOOOOOOOOOHOOOHOOOHOHOOOHOHOOOOOOOHOOOHOOOOOOOOOOOOOHOOOOOHOOOOOOOHOHOH
OHHHHHHHOHOHOHHHHHOHOHOHOHHHHHHHHHHHHHOHOHHHOHHHOHOHHHOHOHHHHHHHHHOHHHHHHHOHHHHHHHHHHHHHOHHHHHHHOHOH
OHOOOOOHOHOHOHOOOHOOOHOHOHOOOOOHOOOOOHOHOOOHOOOOOHOOOHOHOHOOOOOOOOOHOOOOOHOOOOOOOOOOOOOHOHOOOOOHOOOH
OHOHHHOHOHHHOHHHOHHHHHOHOHOHHHHHOHHHOHOHHHOHOHHHHHHHOHHHOHOHHHHHHHHHOHHHOHHHHHHHHHHHHHOHOHOHHHOHHHOH
OHOHOHOHOOOHOHOOOOOOOHOOOHOOOOOOOOOHOHOOOOOHOHOOOOOOOHOOOHOHOOOOOOOOOOOHOHOOOOOOOOOOOOOOOHOOOHOHOOOH
OHOHOHOHHHOHOHOHHHHHHHHHHHHHHHOHHHHHOHHHHHHHOHOHHHHHOHOHHHOHOHHHHHHHHHHHOHHHHHOHHHHHHHHHHHHHOHOHHHHH
OHOHOHOHOOOHOHOHOOOHOOOOOOOOOHOHOOOHOHOOOOOOOHOHOOOOOHOOOHOHOOOOOHOHOOOHOOOOOHOOOOOHOOOHOOOHOHOOOOOH
HHOHOHOHOHOHOHOHOHOHOHOHHHHHOHOHOHOHOHOHHHHHHHOHOHHHHHHHOHHHHHHHOHOHOHOHHHHHOHHHHHOHOHOHOHOHOHHHHHOH
OOOHOOOOOHOHOHOOOHOOOHOOOHOHOHOHOHOOOHOHOHOOOHOHOOOHOOOHOOOOOHOOOOOHOHOOOOOOOHOOOHOHOHOOOHOHOHOHOOOH
OHHHOHHHHHHHOHOHHHHHHHHHOHOHOHOHOHOHHHOHOHOHOHOHHHHHOHOHHHOHHHOHHHHHOHHHHHHHOHOHOHHHOHHHHHOHOHOHOHHH
OOOHOHOHOOOOOHOOOOOOOOOHOHOHOHOHOHOHOOOOOHOHOOOHOOOHOHOOOOOHOOOHOOOOOHOOOOOHOHOHOOOOOHOHOOOHOOOHOOOH
OHOHOHOHOHHHHHHHOHHHHHHHOHOHOHOHOHHHOHHHHHOHHHHHOHOHOHHHHHOHOHHHOHHHHHOHHHOHOHOHHHHHHHOHOHHHOHHHHHOH
OHOHOOOHOOOHOOOHOHOOOOOOOHOHOHOHOOOHOOOHOOOHOOOOOHOOOHOOOHOHOHOHOOOOOHOHOOOHOHOOOOOHOOOHOOOHOHOOOOOH
HHOHOHHHHHOHOHOHHHOHHHHHHHOHOHOHHHOHHHOHOHOHOHHHHHHHHHOHOHOHOHOHHHHHOHOHOHOHOHHHHHOHOHHHHHOHOHOHHHHH
OOOHOHOOOHOOOHOHOOOHOOOOOHOOOHOOOHOOOHOHOHOHOOOOOOOOOOOHOHOHOHOOOOOHOHOHOHOHOHOOOHOHOHOOOHOHOHOOOOOH
OHHHOHOHOHHHHHOHOHHHOHHHOHOHHHHHOHHHOHOHOHHHHHHHHHHHHHHHOHHHOHOHHHOHOHOHOHHHOHOHOHOHOHOHOHOHOHHHHHOH
OOOHOHOHOOOOOOOHOHOOOHOOOHOHOOOOOOOHOHOHOOOOOOOOOOOHOOOHOOOHOHOOOHOHOHOHOOOOOOOHOHOHOOOHOHOOOHOOOHOH
HHOHOHOHHHHHHHHHOHHHOHOHHHOHHHHHHHOHOHOHHHOHHHHHOHHHOHOHHHOHOHHHHHOHOHHHHHHHHHHHHHOHOHHHOHHHHHOHOHOH
OOOHOHOHOOOHOOOHOOOHOHOOOHOOOOOOOHOHOHOOOHOHOOOOOHOOOHOOOOOHOHOOOOOHOOOHOOOOOOOOOOOHOOOHOOOOOOOHOHOH
OHHHHHOHOHOHOHOHOHOHOHHHHHHHHHHHOHOHOHHHOHOHHHHHHHOHHHHHOHHHOHOHHHOHHHOHOHHHHHHHHHHHHHHHOHHHHHHHHHOH
OHOOOOOHOHOOOHOOOHOHOOOHOOOHOOOHOHOHOOOHOHOHOOOOOHOOOOOHOHOOOHOOOHOHOOOHOOOHOOOOOOOOOHOOOHOOOHOOOHOH
OHOHHHHHOHHHHHHHHHOHOHOHOHOHOHOHOHOHHHOHOHOHOHHHOHHHHHOHOHOHHHHHOHOHOHHHHHOHHHHHHHOHOHOHHHOHOHOHOHOH
OHOHOOOOOOOHOOOOOOOHOHOOOHOHOHOHOHOHOOOHOHOOOOOHOOOHOHOHOHOHOOOOOHOHOOOOOOOHOOOOOOOHOOOHOOOHOHOHOHOH
OHOHHHHHOHHHOHHHHHHHOHHHHHOHOHOHOHOHOHHHOHHHHHHHOHOHOHOHHHOHHHOHHHHHHHOHHHHHOHHHHHHHHHOHOHHHOHOHOHOH
OHOOOOOHOHOOOHOOOOOHOHOOOHOHOHOOOHOHOHOOOHOOOHOOOHOHOHOOOHOOOHOHOOOOOHOOOOOOOHOOOHOOOOOHOHOHOOOHOHOH
OHHHHHOHHHOHHHOHHHHHOHOHHHOHOHHHHHOHOHOHHHOHHHOHHHOHOHHHOHHHOHOHOHHHOHHHHHOHHHOHOHHHHHOHOHOHHHHHOHOH
OHOOOHOOOHOHOOOOOHOOOHOHOOOHOOOOOHOHOHOOOHOHOOOHOOOHOOOHOOOHOOOHOOOHOOOOOHOHOOOHOOOOOHOHOHOHOOOOOHOH
OHOHOHHHOHOHHHHHOHOHHHOHOHOHHHHHOHOHOHHHOHOHOHHHOHHHHHOHOHOHHHOHHHOHHHHHOHOHOHHHHHHHOHOHOHOHOHHHHHOH
OOOHOOOHOHOHOOOHOOOOOOOHOHOOOHOOOHOHOOOHOOOHOHOHOHOOOHOHOHOHOOOHOHOHOOOHOHOHOHOOOOOHOHOHOHOHOOOOOOOH
OHHHOHHHOHOHOHOHHHHHHHHHOHHHHHOHHHHHOHHHOHHHOHOHOHOHOHOHOHHHOHHHOHOHOHOHOHHHOHOHHHOHOHHHOHOHHHHHHHOH
OHOHOOOHOHOOOHOOOOOOOOOHOHOOOOOHOOOOOHOOOHOOOHOOOOOHOOOHOOOHOHOOOHOHOHOHOHOOOHOOOHOHOOOOOHOOOOOOOHOH
OHOHHHOHOHOHHHHHHHHHOHOHOHOHHHHHHHOHHHOHHHOHHHHHHHHHHHOHHHOHOHHHOHOHHHOHOHOHHHOHOHOHHHHHHHOHOHHHHHOH
OHOOOHOHOHOHOOOHOOOHOHOHOHOHOOOOOHOOOHOHOOOHOOOOOHOOOHOOOHOOOOOOOHOOOHOHOHOHOHOHOHOOOHOOOHOHOOOOOHOH
OHHHOHOHOHHHOHOHOHOHHHOHOHOHOHHHOHHHOHOHOHHHOHHHOHOHOHOHHHHHHHHHHHHHOHOHOHOHOHOHOHHHOHOHOHOHHHHHOHOH
OOOOOHOOOHOOOHOHOHOOOOOHOHOOOHOHOHOOOHOHOOOOOHOOOHOHOOOHOOOOOOOHOOOOOHOHOOOHOOOHOOOHOHOHOHOOOHOHOOOH
HHHHOHHHHHOHHHOHOHHHHHHHOHHHHHOHOHOHHHOHHHHHHHOHHHOHHHHHOHHHHHOHOHHHHHOHHHHHOHHHHHOHOHHHOHHHOHOHHHHH
OOOHOOOOOOOHOOOHOOOOOHOOOOOHOHOOOHOOOOOOOOOHOOOHOOOHOOOHOOOHOOOHOOOHOOOOOOOHOOOHOOOHOOOOOOOHOHOOOHOH
OHOHHHHHHHHHOHHHOHHHOHOHHHOHOHOHHHHHHHHHHHHHOHHHOHHHOHOHHHOHOHHHHHOHOHHHHHHHHHOHOHHHHHOHHHHHOHOHOHOH
OHOOOOOHOOOHOOOHOHOOOHOOOHOOOHOOOHOOOOOOOOOHOHOOOOOHOHOOOHOHOHOOOOOHOHOOOHOOOOOHOOOOOHOHOOOOOHOHOHOH
OHHHOHOHOHOHHHOHHHOHHHOHOHOHHHHHOHOHHHHHHHOHOHOHHHHHOHHHOHOHOHHHOHHHOHOHOHOHHHHHHHHHOHOHOHHHHHOHOHOH
OHOOOHOHOHOOOHOOOHOOOHOHOHOHOOOOOHOOOHOHOOOHOHOHOOOHOOOHOOOHOOOOOHOOOHOHOHOHOOOOOHOOOHOHOHOOOOOHOOOH
OHOHHOOHOHHHHHHHOHHHOHOHOHOHOHHHHHHHOHOHOHHHOHHHOHOHHHOHHHHHHHHHHHHHOHOHOHOHOHOHOHOHHHHHOHHHHHOHHHOH
OHOOOHOHOHOOOOOHOOOHOHOHOHOHOOOHOOOOOHOHOOOOOHOOOHOOOHOHOOOOSGOOOHOOOHOHOOOHOHOHOHOHOOOHOOOOOOOHOHOH
HHHHOHOHOHOHHHOHHHOHOHHHOHHHHHOHOHHHHHOHHHHHOHOHHHHHOHOHOHHHOHHHOHOHOHOHHHHHOHOHOHOHOHOHHHHHHHHHOHOH
OOOOOHOHOOOHOOOOOHOOOHOOOHOOOHOHOHOHOOOOOHOOOHOHOOOOOOOHOHOHOOOHOHOHOHOHOOOOOHOHOHOOOHOOOOOOOHOOOHOH
OHHHHHOHHHHHOHHHOHHHHHOHOHOHOHOHOHOHOHHHOHOHHHOHHHHHHHOHOHOHOHOHOHOHOHOHHHHHHHOHOHHHHHHHOHHHOHHHOHOH
OHOOOHOHOOOOOHOOOOOOOHOHOHOHOHOOOHOHOHOHOOOHOOOHOOOHOOOHOHOOOHHHOOOHOHOHOOOOOOOHOHOHOOOOOHOOOHOOOHOH
OHOHOHOHOHHHHHHHHHHHOHOHHHOHOHHHHHOHOHOHHHHHOHHHOHOHHHHHOHOHHHOHHHOHHHOHOHHHHHHHOHOHOHHHHHHHOHOHOHOH
OHOHOHOOOHOOOOOHOOOHOOOHOOOHOOOOOOOHOOOOOHOOOHOOOHOOOOOHOHOOOHOHOOOHOOOHOHOOOOOHOHOHOHOOOOOHOOOHOHOH
OHOHOHHHOHOHHHOHHHOHHHOHOHHHHHHHOHHHHHHHOHOHOHOHHHHHHHOHOHHHHHOHHHHHOHHHOHOHHHOHOHOHOHOHHHOHOHHHHHOH
OHOHOOOHOHOHOHOOOHOOOHOHOHOOOOOHOOOOOOOOOHOHOHOHOHOOOOOHOOOOOHOOOOOHOOOOOHOHOHOOOHOHOOOHOHOHOHOOOOOH
OHOHHHOHOHOHOHHHOHOHOHOHOHOHHHHHHHHHHHHHHHOHOHOHOHOHHHHHHHHHOHHHOHOHHHHHHHOHOHHHHHOHHHHHOHOHHHOHHHHH
OHOHOHOHOHOHOHOOOHOHOOOHOHOOOOOOOOOOOOOOOHOHOHOOOHOHOOOOOOOHOOOHOHOOOHOOOHOHOOOOOOOHOOOOOHOOOHOHOOOH
OHOHOHOHHHOHOHOHHHHHHHHHOHHHHHHHHHOHHHHHOHOHHHHHOHOHOHHHHHOHHHOHOHOHHHOHOHOHOHHHHHOHHHHHOHHHOHOHOHOH
OOOOOHOOOOOOOHOOOOOOOOOOOOOOOOOOOOOHOOOOOHOOOOOOOHOOOOOOOHOOOOOHOHOOOOOHOOOOOHOOOOOOOOOOOOOHOOOOOHOH
HHHHHHHHHHHHHHHHHHHHHHHHHHHHHHHHHHHHHHHHHHHHHHHHHHHHHHHHHHHHHHHHHHHHHHHHHHHHHHHHHHHHHHHHHHHHHHHHHHHH
