OOOOOOOOOHOHOOOOOOOOOOOHOOOOOOOOOOOOOOOOOOOOOOOOOOOHOOOOOOOOOOOOOOOOOOOOOOOHOOOOOOOOOHOOOOOOOHOOOOOH
HHHHOHHHOHOHOHHHOHHHOHHHOHHHHHOHHHHHHHHHHHOHHHHHHHHHOHHHHHHHHHOHOHHHHHHHHHOHHHHHOHHHOHOHHHHHOHOHHHOH
OOOOOHOHOHOOOHOHOHOOOHOOOHOOOHOHOOOHOOOOOHOOOOOOOOOOOHOOOOOOOHOHOOOHOOOHOOOHOOOOOHOOOHOOOHOHOOOHOOOH
OHHHHHOHOHOHHHOHOHHHHHOHHHOHOHHHOHOHOHHHOHHHHHHHHHHHOHOHHHHHOHHHHHOHOHOHOHHHOHHHHHHHHHHHOHOHHHHHOHHH
OHOHOOOOOHOOOOOHOOOHOOOHOHOHOOOOOHOHOHOHOHOOOOOHOOOHOHOOOHOHOOOOOHOHOHOHOHOOOOOOOOOOOOOOOOOOOOOHOOOH
OHOHOHHHHHHHHHOHHHOHOHHHOHOHHHHHHHOHOHOHOHOHHHOHOHOHHHOHOHOHHHHHOHOHHHOHOHHHHHHHHHHHHHHHHHHHOHHHHHOH
OHOOOHOOOHOHOOOHOOOHOHOOOHOOOHOOOOOOOHOOOHOOOHOOOHOOOHOHOHOOOOOHOHOOOHOHOOOHOOOOOOOHOOOOOHOOOHOOOOOH
OHHHOHOHOHOHOHHHOHHHOHHHOHHHOHHHHHHHHHOHHHHHOHHHHHHHOHHHOHOHHHHHOHHHOHOHHHOHOHHHHHOHOHHHOHHHHHOHHHOH
OOOHOOOHOHOOOOOHOHOOOHOOOHOHOOOOOOOHOOOOOOOHOOOHOOOHOOOOOHOHOOOOOHOOOHOOOHOOOHOOOHOHOHOHOOOOOHOOOHOH
OHOHHHHHOHOHHHHHOHOHHHOHOHOHHHHHHHOHHHHHHHOHOHOHHHOHHHHHHHOHOHHHHHOHHHOHHHHHHHOHHHOHOHOHHHHHOHHHOHOH
OHOOOHOHOHOOOHOOOHOHOOOHOHOOOOOHOHOOOHOOOOOHOHOOOHOOOOOOOOOHOHOOOOOHOOOHOOOOOHOOOHOOOHOOOOOHOOOHOHOH
OHHHOHOHOHHHHHOHHHOHHHOHOHHHOHOHOHHHOHHHOHHHOHHHOHOHHHHHOHOHOHOHHHHHHHOHOHHHOHOHOHHHHHHHOHOHHHOHOHOH
OHOHOHOOOOOOOHOOOHOOOOOHOOOOOHOOOHOHOOOHOHOOOOOHOHOHOOOOOHOHOHOHOOOOOHOHOOOHOHOHOHOOOOOOOHOHOOOHOHOH
OHOHOHHHHHHHOHHHOHOHHHHHOHHHHHHHOHOHHHOHOHHHHHHHOHOHOHHHHHOHOHOHOHOHOHOHHHOHOHOHOHOHHHOHHHOHOHHHOHOH
OOOHOOOOOHOHOOOHOHOHOOOHOHOOOOOHOOOHOOOHOOOOOOOOOHOHOOOHOOOHOOOHOHOHOOOOOHOHOOOHOHOOOHOOOHOHOHOOOHOH
HHOHHHHHOHOHHHOHOHOHOHOHHHOHHHOHHHOHOHHHHHHHHHHHHHOHHHOHHHHHHHHHHHOHHHHHHHOHHHHHOHHHOHHHOHHHOHOHOHOH
OHOOOHOOOHOOOHOHOOOHOHOOOHOHOOOHOOOHOHOOOOOOOOOOOHOHOHOHOOOOOOOOOHOOOOOOOHOHOOOHOOOOOHOHOOOOOHOHOHOH
OHHHOHOHHHOHOHOHHHHHOHHHOHOHOHHHHHHHOHOHHHHHOHHHHHOHOHOHOHOHHHHHOHHHHHHHOHOHOHOHHHHHHHOHHHHHHHOHOHOH
OOOOOHOHOOOHOOOOOOOOOHOOOOOHOOOOOOOOOHOOOHOOOHOOOHOOOHOHOHOOOHOHOOOOOHOOOHOOOHOOOHOOOOOOOHOOOOOHOHOH
OHHHHHOHOHHHHHHHHHHHHHOHHHHHHHHHHHHHHHHHOHHHHHOHOHHHOHOHOHHHOHOHHHHHOHOHOHHHHHHHOHHHOHOHOHOHHHHHOHOH
OOOHOHOHOHOOOOOOOOOOOHOOOHOOOOOOOOOHOOOHOOOOOOOHOOOOOHOOOHOOOHOOOOOHOOOHOHOOOOOHOOOHOHOHOHOHOOOHOHOH
HHOHOHOHHHOHHHHHHHHHOHHHOHOHHHHHHHOHOHOHOHHHHHHHHHHHHHHHHHOHHHOHHHOHHHHHOHHHHHOHHHOHHHOHOHOHHHOHOHHH
OHOHOHOOOHOOOOOOOOOHOHOOOHOHOHOOOOOHOHOHOOOOOOOHOOOOOOOOOHOOOHOHOHOOOOOHOHOOOOOHOHOOOOOHOHOOOOOHOOOH
OHOHOHHHOHHHHHOHHHHHOHHHHHOHOHOHOHHHOHOHHHHHHHOHOHOHHHHHHHHHOHOHOHOHHHHHOHOHHHOHOHHHHHHHOHHHHHHHHHOH
OHOOOHOOOHOOOHOHOOOOOHOOOOOHOHOHOHOOOHOOOHOOOOOHOHOHOOOOOOOOOHOOOHOOOOOHOOOHOOOHOHOOOOOOOHOOOOOOOHOH
OHHHOHOHOHOHHHOHOHHHHHOHHHHHOHOHHHOHHHHHOHOHHHHHOHOHOHHHOHHHHHHHHHOHHHOHHHHHOHHHOHOHHHHHHHOHHHHHOHOH
OOOOOHOHOHOHOOOHOOOHOOOOOOOOOHOOOOOHOOOOOHOOOHOOOHOHOOOHOHOOOOOOOHOOOHOOOHOOOOOOOHOOOHOOOOOHOOOOOHOH
OHHHHHOHOHOHOHHHHHOHOHHHHHHHOHHHHHHHOHHHHHHHOHOHHHOHHHOHHHOHHHHHOHHHHHHHOHOHHHHHHHHHOHOHHHHHOHHHHHOH
OOOOOHOHOHOHOOOOOHOHOOOHOOOHOOOHOOOHOOOOOHOHOOOHOOOHOHOOOOOOOOOHOHOOOOOHOOOOOHOOOOOHOHOHOOOOOOOHOOOH
HHHHHHOHOHOHHHHHOHOHHHOHOHOHHHOHOHOHHHHHOHOHHHHHOHHHOHHHHHHHHHHHOHOHHHOHHHHHHHOHHHOHOHOHHHHHHHOHHHOH
OOOHOOOHOOOHOOOOOHOOOOOHOHOOOHOHOHOHOOOOOHSHOOOOOHOOOOOOOHOOOOOOOHOHOHOOOOOOOHOOOHOHOHOOOOOHOHOHOOOH
OHOHOHHHHHOHOHHHHHHHHHHHOHHHOHOHOHHHOHHHHHGHOHHHHHHHHHOHOHOHHHHHHHOHOHHHHHHHOHHHOHOHOHHHHHOHOHOHOHHH
OHOOOHOOOOOHOHOOOOOOOHOOOHOOOHOOOHOOOHOOOOOHOOOOOHOOOOOHOHOOOHOOOHOOOHOOOOOHOOOOOHOOOHOOOOOHOOOHOOOH
OHHHHHOHHHHHOHOHHHOHOHOHHHOHHHOHHHOHOHOHHHHHHHHHOHOHHHHHOHHHOHOHOHHHOHOHHHHHHHHHHHHHHHOHHHHHOHHHHHOH
OOOHOHOHOHOOOHOOOHOHOHOHOOOHOOOHOOOHOHOOOOOOOHOHOOOHOHOOOHOHOOOHOOOOOHOHOOOHOOOOOOOHOOOHOOOHOOOHOOOH
HHOHOHOHOHOHHHHHHHOHOHOHOHHHHHHHOHHHHHHHHHHHOHOHHHHHOHOHHHOHHHHHHHHHHHOHOHOHOHHHOHOHOHHHOHOHHHOHOHOH
OOOHOHOHOHOOOOOOOOOHOHOHOOOOOOOOOHOOOOOOOOOOOHOOOOOHOOOHOOOHOOOOOOOOOOOOOHOOOOOHOHOOOHOOOHOOOHOOOHOH
OHHHOHOHOHHHOHHHHHHHHHOHHHHHHHOHHHOHHHHHHHHHHHOHOHOHOHHHOHOHOHHHHHHHHHHHHHHHHHOHOHHHHHOHHHHHOHHHHHOH
OHOOOOOHOOOHOHOOOOOOOOOHOHOOOOOHOOOHOOOHOOOOOOOHOHOHOOOHOHOOOHOOOOOOOOOOOOOHOOOHOOOHOOOHOOOOOOOOOHOH
OHHHHHOHOHOHOHOHHHHHHHHHOHOHHHHHOHHHOHHHOHHHHHHHOHOHHHOHOHHHHHOHHHHHHHHHHHOHOHHHHHOHOHHHHHHHHHHHHHOH
OOOOOHOOOHOHOHOOOOOOOHOOOOOHOOOOOHOOOOOOOHOOOHOHOHOOOHOHOOOOOHOOOOOOOHOOOHOHOHOOOOOHOOOOOHOOOOOOOOOH
HHHHOHHHHHOHOHHHHHHHOHHHHHHHOHHHHHOHHHHHHHOHOHOHOHHHHHOHHHHHHHHHOHHHOHOHOHOHHHOHHHHHOHHHOHOHHHHHHHHH
OOOHOOOHOHOHOHOOOOOHOOOHOOOOOHOOOHOOOOOOOOOHOOOHOOOOOOOHOOOOOOOHOHOOOHOHOHOHOOOHOHOOOOOHOHOOOHOOOOOH
HHOHHHOHOHOHOHOHHHHHHHOHOHHHHHOHOHHHHHHHHHHHHHOHHHHHHHHHOHHHHHOHHHOHHHOHHHOHOHHHOHOHHHHHOHHHOHOHOHHH
OOOOOHOHOHOHOHOOOOOHOOOHOOOOOHOHOOOHOOOOOOOOOHOOOOOHOOOOOHOOOHOHOOOHOOOHOOOHOHOHOOOHOOOHOHOOOHOHOOOH
OHOHHHOHOHOHOHHHHHOHOHOHHHHHOHOHHHOHOHHHHHOHOHHHHHOHOHHHHHOHOHOHOHHHOHOHOHHHOHOHOHHHOHOHOHOHHHOHHHOH
OHOHOOOHOHOHOHOOOOOHOHOHOOOHOOOHOHOHOHOOOOOHOOOHOHOOOHOOOOOHOHOOOHOHOHOHOOOOOHOOOHOOOHOOOHOHOOOHOOOH
OHOHOHHHOHOHOHOHHHHHOHHHOHOHHHHHOHOHOHOHHHHHHHOHOHHHHHOHHHHHHHHHHHOHOHOHHHHHHHHHHHOHHHHHHHOHHHHHOHOH
OHOHOHOOOOOHOOOHOOOOOHOOOHOOOOOHOOOHOHOHOOOHOOOHOOOOOHOHOOOOOOOHOOOOOHOOOHOOOOOOOOOHOOOOOHOOOHOOOHOH
OHHHOHHHHHHHOHHHOHHHOHOHHHHHOHHHOHHHHHOHOHHHOHHHOHHHOHOHOHHHHHOHOHHHHHOHHHOHHHOHHHOHOHHHOHHHOHOHHHOH
OOOHOOOOOOOOOHOOOHOOOHOOOOOHOOOHOHOOOOOHOHOOOHOOOHOHOHOOOOOHOOOHOHOHOOOHOOOOOHOHOOOHOHOHOOOHOHOOOHOH
HHOHHHHHHHHHHHOHHHHHHHHHHHOHHHOHOHHHOHHHOHOHHHHHOHOHOHHHHHHHOHOHOHOHOHHHOHHHHHOHOHHHOHOHHHOHOHOHOHOH
OOOOOOOHOOOOOHOOOOOOOOOHOOOHOHOOOHOOOHOHOOOHOOOOOHOHOHOOOOOOOHOHOOOHOHOOOHOOOOOHOHOHOHOHOOOHOHOHOHOH
OHHHHHOHHHHHOHHHHHHHHHOHOHHHOHHHHHOHHHOHOHHHOHHHHHOHOHOHHHHHHHOHHHOHOHOHHHOHHHHHOHOHOHOHOHHHOHHHOHOH
OHOOOHOOOOOOOOOOOHOOOHOOOHOOOOOOOHOOOHOHOHOOOHOOOOOOOHOOOHOOOOOOOHOHOOOHOOOHOOOOOHOHOOOHOHOOOHOOOHOH
OHOHOHHHHHHHHHHHHHOHOHHHHHHHOHOHHHOHOHOHOHOHOHHHOHHHHHHHOHHHHHOHHHOHHHHHOHHHHHOHHHOHOHHHOHOHHHOHHHOH
OOOHOHOOOOOHOOOHOOOHOOOOOOOOOHOHOOOHOHOHOHOHOOOHOOOOOOOOOHOOOHOHOOOHOOOHOOOOOHOHOOOHOHOOOHOOOOOHOHOH
HHHHOHOHHHOHOHOHOHHHOHHHHHHHHHOHOHHHOHOHOHHHHHOHHHHHHHOHHHOHOHHHOHHHOHOHHHHHOHOHOHHHOHOHOHHHHHHHOHOH
OOOOOHOHOHOOOHOHOOOHOOOHOOOHOOOHOHOOOHOOOOOOOOOHOOOHOOOHOOOHOOOOOHOOOHOHOOOHOHOOOHOOOHOHOHOOOOOHOOOH
OHOHHHOHOHHHHHOHOHHHHHOHOHOHOHHHOHOHHHOHHHHHHHHHOHOHOHHHOHHHHHHHHHHHOHOHHHOHOHHHHHOHHHOHHHOHOHHHOHHH
OHOHOOOHOHOOOHOHOHOOOHOHOHOHOHOOOHOOOHOHOOOHOOOHOHOOOOOHOHOOOOOOOOOHOHOOOOOHOHOOOOOOOHOHOOOHOOOOOHOH
OHHHOHHHOHOHOHOHOHOHOHOHOHOHOHOHHHHHOHHHOHOHOHOHHHHHHHOHOHHHHHHHOHOHOHHHOHOHOHOHHHHHHHOHOHHHHHHHHHOH
OOOHOHOOOOOHOHOOOHOHOOOHOHOOOHOOOHOOOHOOOHOOOHOOOOOHOOOHOOOOOOOOOHOOOHOOOHOHOHOHOHOOOOOHOOOHOOOOOHOH
OHOHOHOHHHHHOHHHHHOHHHHHHHHHHHHHOHOHHHOHHHHHHHHHHHOHOHHHHHHHHHHHHHHHHHOHHHOHOHOHOHOHHHHHHHOHOHHHOHOH
OHOHOHOHOOOOOHOOOHOOOOOHOOOOOHOOOHOOOOOHOOOHOOOOOHOHOHOOOOOOOHOOOOOOOHOOOOOHOHOOOHOHOOOOOOOHOHOHOOOH
OHOHOHHHOHHHOHHHOHHHHHOHOHHHOHOHHHHHHHHHHHOHOHHHOHOHOHHHOHHHOHOHHHHHHHHHOHHHOHHHOHOHOHHHHHHHOHOHHHOH
OHOHOOOOOHOHOOOHOHOOOHOOOHOHOHOHOOOOOOOOOHOHOOOHOOOHOHOOOHOOOHOOOHOOOOOOOHOOOOOHOHOOOHOOOOOOOHOHOOOH
HHOHHHHHHHOHHHOHOHOHOHHHHHOHOHOHOHHHHHHHOHOHHHOHHHHHOHOHHHOHHHOHOHOHHHHHHHOHOHHHOHHHHHHHOHHHOHOHOHHH
OOOHOOOHOOOOOHOHOOOHOOOOOOOHOOOHOOOOOHOOOHOHOOOHOHOOOHOHOOOHOOOHOHOHOOOOOHOHOHOOOHOOOOOHOHOOOHOHOHOH
OHHHOHOHOHOHHHOHOHHHHHHHOHHHHHHHOHHHOHOHHHOHOHHHOHOHHHOHHHOHHHHHOHOHHHOHOHOHHHOHHHOHHHOHOHOHHHOHOHOH
OOOHOHOOOHOOOOOHOHOOOHOOOHOOOHOOOHOHOHOOOHOHOHOOOHOOOHOOOHOOOOOHOHOOOOOHOHOOOOOHOOOHOOOHOHOHOOOOOOOH
OHOHOHHHHHHHHHHHHHOHOHOHHHOHOHOHHHOHOHHHOHOHOHHHOHHHOHHHOHHHHHOHOHHHHHHHOHHHHHHHOHOHHHOHHHOHHHHHHHOH
OHOHOOOHOOOOOOOOOHOHOOOHOOOHOOOOOOOHOHOOOOOHOOOHOOOHOOOHOHOOOHOOOOOOOHOOOHOOOOOHOHOOOHOOOHOHOOOOOHOH
OHOHHHOHHHOHHHHHOHOHHHOHOHHHHHHHHHHHOHHHHHHHHHOHOHOHHHOHOHOHHHHHHHHHOHOHHHHHOHOHOHHHOHHHOHOHOHHHOHOH
OHOOOHOOOOOHOOOHOHOHOOOHOOOHOOOOOOOHOOOHOOOHOOOHOHOOOHOOOHOOOOOOOHOOOHOOOOOHOHOOOOOHOOOHOOOHOHOOOHOH
HHOHOHHHHHHHOHHHOHOHHHHHHHOHOHHHHHOHOHOHOHOHOHHHOHHHOHHHHHOHHHOHHHOHHHHHHHOHHHHHHHHHHHOHHHOHOHOHHHHH
OOOHOOOHOOOOOOOHOHOOOOOHOOOHOHOOOHOHOHOHOHOOOHOOOOOHOOOHOOOOOHOOOOOOOOOHOOOHOOOOOOOOOOOHOOOHOHOOOOOH
OHHHHHHHOHHHHHOHOHHHOHOHOHHHOHHHOHOHOHOHOHHHHHOHHHHHOHOHOHHHHHHHHHHHHHOHOHHHOHHHHHHHOHHHHHHHOHHHHHOH
OOOOOOOOOHOHOOOHOOOHOHOHOOOHOOOHOOOHOHOHOHOOOHOHOOOHOHOHOHOOOOOHOOOHOOOHOHOHOOOOOOOHOHOOOOOOOHOHOOOH
OHHHHHHHHHOHOHOHHHOHOHOHHHOHHHOHOHHHHHOHOHOHOHHHOHOHOHOHOHOHHHOHOHOHHHOHOHOHOHHHHHOHHHOHHHHHHHOHOHHH
OHOHOOOOOOOHOHOHOOOHOHOOOOOOOHOHOOOOOOOHOHOHOOOHOHOOOHOHOHOHOHOHOHOOOHOHOHOOOHOOOHOOOHOOOOOHOOOHOOOH
OHOHOHOHOHHHOHOHOHHHHHHHHHHHHHOHHHHHHHOHOHOHHHOHOHHHHHHHOHOHOHOHOHHHOHHHOHHHHHOHOHHHOHHHHHOHHHOHHHOH
OHOOOHOHOHOOOHOHOOOOOOOOOOOHOOOHOOOOOOOHOOOHOHOHOOOHOOOOOHOHOHOOOOOHOOOHOOOOOOOHOOOHOOOOOOOHOOOHOHOH
OHHHHHOHOHOHHHHHHHHHHHHHHHOHOHHHOHHHHHHHHHHHOHOHHHOHOHHHHHOHOHHHHHHHOHOHHHHHHHHHHHOHOHHHHHHHOHOHOHOH
OOOOOHOHOHOHOOOOOOOOOOOOOHOHOOOHOHOOOOOOOHOOOHOOOHOOOHOOOOOOOHOOOOOHOHOOOHOOOOOOOOOHOOOOOOOOOHOHOHOH
HHHHOHOHHHOHOHHHHHHHHHOHOHOHHHOHOHHHHHOHOHHHOHHHOHHHHHOHHHHHHHOHHHOHHHHHOHOHHHHHHHHHOHHHHHHHHHOHOHOH
OOOOOHOHOOOHOOOHOOOOOOOHOHOOOHOHOOOHOOOHOOOOOOOHOOOOOOOHOOOOOHOHOHOOOOOOOHOOOHOOOOOHOHOOOHOHOOOOOHOH
OHHHHHOHOHHHHHOHOHHHHHHHOHHHOHOHHHOHOHHHHHOHHHHHHHHHHHOHOHHHOHOHOHHHHHHHOHHHOHOHHHOHOHOHOHOHOHHHHHOH
OHOOOHOHOOOOOOOHOOOOOHOOOOOHOOOHOHOOOHOOOHOHOOOOOHOOOHOHOOOHOOOHOOOHOOOOOHOHOHOOOHOOOHOHOHOOOHOOOOOH
OHOHOHOHHHHHHHHHHHHHOHOHHHHHHHHHOHOHHHOHOHHHOHHHOHOHOHHHHHOHHHHHOHOHOHHHHHOHOHHHOHHHHHOHOHHHHHOHHHOH
OOOHOHOOOOOHOOOOOOOOOHOHOOOOOOOHOOOHOOOHOOOHOHOOOOOHOOOOOOOHOOOHOHOHOHOOOOOHOHOOOHOOOHOHOOOOOOOHOHOH
HHHHOHOHHHHHOHHHHHHHOHHHOHOHHHHHOHHHOHHHHHOHOHOHHHHHHHHHHHHHOHOHOHOHOHHHHHOHOHOHHHOHOHOHHHHHHHHHOHOH
OHOOOOOHOOOOOHOOOOOOOHOOOHOOOOOOOOOHOHOHOOOOOHOHOHOOOOOHOOOOOHOHOHOOOHOOOHOHOHOOOHOHOOOHOOOHOHOOOOOH
OHOHHHHHOHOHHHHHOHHHHHOHHHHHHHHHHHHHOHOHOHHHHHOHOHOHHHOHOHHHHHOHHHOHHHOHOHOHOHHHOHOHHHHHOHOHOHOHHHHH
OHOOOHOOOHOHOOOHOOOHOOOHOOOOOOOHOHOOOHOOOHOOOHOOOHOHOOOHOOOHOHOOOHOOOOOHOOOHOHOOOHOHOOOOOHOOOHOHOOOH
OHHHOHOHHHHHOHOHHHHHOHHHOHHHHHOHOHOHHHOHHHOHOHOHHHOHOHHHHHOHOHHHOHHHOHHHHHHHOHHHHHOHOHHHOHHHHHOHHHOH
OHOOOHOOOHOOOHOHOOOHOOOHOHOOOHOHOHOHOOOOOHOHOHOHOOOHOHOOOOOHOOOHOHOOOHOOOOOOOHOOOOOHOOOHOHOOOHOOOOOH
OHOHHHHHOHOHHHOHOHOHHHOHOHOHHHOHOHOHHHHHHHOHOHHHOHHHOHOHHHHHHHOHOHHHHHOHHHHHHHOHHHHHHHOHOHOHOHHHHHOH
OOOOOOOHOOOOOHOOOHOOOOOOOHOOOOOOOHOOOOOOOOOHOOOOOOOHOOOOOOOOOOOHOOOOOOOOOOOOOOOHOOOOOOOHOOOHOOOOOOOH
HHHHHHHHHHHHHHHHHHHHHHHHHHHHHHHHHHHHHHHHHHHHHHHHHHHHHHHHHHHHHHHHHHHHHHHHHHHHHHHHHHHHHHHHHHHHHHHHHHHH
