SOGHOOOOOH
OHHHOHHHOH
OHOOOHOOOH
OHOHOHOHHH
OHOHOHOOOH
OHOHOHHHOH
OHOHOHOOOH
OHHHOHOHHH
OOOOOHOOOH
HHHHHHHHHH
