OOOOOOOOOH
OHHHHHHHOH
OOOOOHOOOH
OHHHOHHHHH
OOOHOHOOOH
HHOHOHOHOH
OHOHOHOHOH
OHOHOHOHOH
OOOHOOSGOH
HHHHHHHHHH
