OOOOOOOOOH
OHHHHHHHHH
OOOOOOOOOH
OHHHHHHHOH
OOOOOHOHOH
HHHHOHOHOH
OHOOOOOHOH
OHOHHHHHOH
OOOHGOSOOH
HHHHHHHHHH
