GHOOOOOHOH
OHOHHHOHOH
SOOHOOOHOH
HHHHOHHHOH
OOOHOOOHOH
OHOHHHOHOH
OHOOOHOHOH
OHHHOHOHOH
OOOHOOOOOH
HHHHHHHHHH
