SOOHOOOOOH
OHOHOHOHHH
GHOHOHOOOH
HHOHHHHHOH
OHOOOOOOOH
OHHHHHHHOH
OOOHOOOHOH
OHOHOHOHOH
OHOOOHOOOH
HHHHHHHHHH
