OOOOOOOOOH
OHHHHHHHOH
OHOOOOOHOH
OHHHOHOOOH
OOOHGHSOOH
OHOHOHOHHH
OHOOOHOOOH
OHHHHHHHOH
OOOOOOOOOH
HHHHHHHHHH
