OOOHOOOOOH
OHHHOHOHOH
SOOOOHOHOH
GHOHHHOHHH
OOOOOHOOOH
HHHHOHHHOH
OHOOOHOOOH
OHOHHHOHOH
OOOOOOOHOH
HHHHHHHHHH
