OOOHOOOOGH
HHOHOHOHOH
OOOHOHOHOH
OHHHOHOHHH
OHOOOHOOOH
OHOHHHHOOH
OHOHSOOHOH
OHOHOHOHOH
OOOOOHOOOH
HHHHHHHHHH
