OHOOOOOOOH
OHOHHHHHOH
OHOOSHOHOH
OHHHOHOHOH
OOOHOHOOOH
OOHHHHOHOH
OOOOOHOHOH
OHHHOHOHOH
OOOHOOOOGH
HHHHHHHHHH
