OOOHOOOOOH
OHHHOHHHOH
OOOOOHOOGH
OHHHHHOHHH
OHOOOHOOOH
OHOHHHHOOH
OOOHOOOHOH
OHOHOHOHOH
OOSOOHOOOH
HHHHHHHHHH
