OOOOOOOHOOOOOOOHOOOHOOOOOOOOOHOOOOOHOOOOOOOOOOOOOH
OHOHHHOHHHOHHHOHOHOHHHHHHHOHOHHHHHOHOHHHOHHHHHHHOH
OHOHOOOOOOOHOOOHOHOOOOOOOHOHOHOOOHOOOHOOOHOOOHOOOH
OHOHHHHHHHHHOHHHOHHHHHHHOHOHOHOHOHHHHHOHHHOHOHOHHH
OHOOOOOOOHOHOOOHOHOOOOOOOHOHOOOHOOOOOHOOOHOHOHOHOH
OHHHHHHHOHOHHHOHOHOHHHHHHHOHHHHHHHHHOHHHOHOHOHOHOH
OOOHOOOHOHOOOOOOOHOHOOOOOHOHOOOHOOOOOHOOOHOHOHOOOH
OHHHOHOHOHOHHHHHHHOHOHHHOHOHOHOHOHHHHHOHHHHHOHHHOH
OHOOOHOHOHOOOHOOOHOOOHOHOHOHOHOHOOOHOOOOOOOHOOOHOH
OHOHHHOHOHHHOHOHOHHHHHOHOHOHOHOHHHOHHHHHHHOHOHHHOH
OHOHOOOOOHOOOHOHOOOOOHOHOHOHOHOHOOOHOOOOOOOHOOOOOH
OHOHHHHHHHHHHHOHHHHHOHOHOHOHOHOHHHOHOHHHHHHHOHHHHH
OHOOOHOOOOOHOOOHOOOHOHOOOHOHOHOOOHOOOHOOOOOOOHOOOH
OHHHOHOHHHOHOHHHOHOHOHOHHHOHOHHHOHHHHHOHHHHHHHHHOH
OHOHOOOOOHOOOOOHOHOOOHOOOOOHOOOHOOOOOHOHOOOOOOOHOH
OHOHHHHHHHHHHHHHOHHHHHHHOHHHHHOHHHHHOHOHHHOHOHOHOH
OOOOOHOOOOOHOOOOOHOOOOOOOHOOOHOOOHOOOHOOOHOHOHOOOH
HHOHHHOHHHOHOHHHHHOHHHHHHHOHOHHHOHOHHHHHOHHHOHHHOH
OOOHOOOHOOOOOHOOOHOHOHOOOOOHOOOOOHOHOOOHOOOHOOOHOH
OHHHOHHHHHHHHHOHHHOHOHOHHHHHHHHHHHOHOHHHHHOHOHOHOH
OHOHOHOOOOOHOOOOOOOOOHOOOOOHOOOOOHOHOOOOOHOHOHOHOH
OHOHOHOHHHOHHHOHHHHHHHHHHHOHOHHHOHOHHHHHOHOHOHOHOH
OHOHOHOHOHOOOHOHOOOHOOOOOOOHOHOOOOOHOOOHOOOHOHOHOH
OHOHOHOHOHHHOHHHOHOHOHHHHHHHOHHHHHHHOHOHOHHHHHOHOH
OOOHOHOOOOOHOHOOOHOOOHOOOOOHOHOOOOOOOHOHOOOOOOOHOH
HHHHOHHHHHOHOHOHHHHHHHHHHHOHOHOHHHHHOHOHHHOHHHHHHH
OOOOOHOOOHOHOOOHOOOOOOOOOHOHOOOHOOOHOHOHOOOHOOOOOH
OHHHOHOHOHOHHHHHHHHHHHOHOHOHHHHHOHOHHHOHHHHHOHHHOH
OOOHOOOHOHOHOOOOOOOOOOOHOOOHOOOOOHOOOHOHOOOOOOOHOH
HHOHOHHHHHOHOHHHHHHHHHHHHHOHOHHHHHHHOHOHOHHHHHHHOH
OOOHOHOOOOOHOHOOOHOOOOOOOHOHOOOOOHOOOHOOOOOHOOOOOH
OHHHHHOHHHHHOHOHOHOHHHOHHHOHHHHHOHHHOHHHHHOHOHHHOH
OOOOOHOHOOOOOOOHOHOOOHOOOOOHOOOHOOOHOOOHOHOHOHOHOH
OHHHOHOHOHHHHHHHOHHHOHHHHHHHOHOHHHOHHHOHOHOHOHOHOH
OOOHOOOHOHOOOOOOOHOHOOOOOOOHOHOOOHOHOOOHOOOHOHOOOH
HHOHHHHHHHOHHHHHHHOHHHHHHHOHHHOHHHOHOHHHHHHHOHOHHH
OHOOOOOHOOOHOOOHOOOHOOOOOHOOOHOOOHOHOOOOOOOOOHOOOH
OHHHHHOHOHHHHHOHOHOHOHHHOHHHOHHHOHOHHHHHOHHHHHHHOH
OOOHOHOOOHOOOOOHOHOOOHOHOOOOOHOOOHOOOOOHOHOOOHOHOH
OHOHOHHHHHOHHHHHOHHHHHOHHHHHHHOHOHHHHHOHHHOHOHOHOH
OHOOOOOHOOOOOOOHOHOOOOOOOOOOOOOHOHOHOOOHOOOHOHOOOH
OHHHHHOHOHHHHHOHOHHHHHHHHHOHHHHHOHOHOHHHOHHHOHOHHH
OOOOOHOHOOOHOHOOOHOOOOOOOOOHOOOOOOOHOOOOOHOOOHOOOH
OHHHOHHHHHOHOHHHHHOHHHHHHHHHOHHHHHHHHHHHHHOHHHHHOH
OHOHOOOOOHOOOOOOOOOHOHOOOOOOOHOHOOSOOHOOOOOHOOOHOH
OHOHHHHHOHHHHHHHHHHHOHOHHHHHHHOHOHGHOHOHHHHHOHOHOH
OHOOOHOHOOOHOOOOOOOHOOOHOOOOOHOHOOOHOHOHOOOHOHOOOH
OHOHOHOHOHHHOHHHOHHHOHHHOHHHOHOHHHHHOHOHOHHHOHHHHH
OOOHOOOHOOOOOOOHOOOOOOOOOHOOOOOOOOOHOOOHOOOOOOOOOH
HHHHHHHHHHHHHHHHHHHHHHHHHHHHHHHHHHHHHHHHHHHHHHHHHH
