OHOOOOOOOHOOOOOOOOOHOOOOOOOHOOOOOOOOOOOOOHOOOOOOOH
OHOHOHHHOHHHOHHHHHOHHHOHHHHHOHOHHHHHHHHHOHOHHHHHOH
OOOHOHOHOOOHOOOHOHOHOOOHOOOOOHOOOOOHOOOHOHOHOOOHOH
HHHHOHOHHHOHHHOHOHOHOHOHOHHHHHHHHHOHOHOHHHOHOHHHOH
OOOOOHOOOHOHOOOHOHOHOHOHOHOOOHOOOOOHOHOOOOOOOHOOOH
OHHHHHOHHHOHOHHHOHOHOHHHOHOHHHOHHHOHOHHHHHHHHHOHOH
OHOOOHOOOOOOOHOOOOOHOHOOOHOOOHOHOOOHOHOOOOOHOOOHOH
OHOHHHOHHHHHHHHHHHOHOHOHHHHHOHOHHHHHOHHHOHHHOHHHOH
OHOOOHOOOHOOOOOOOHOOOHOOOHOOOHOOOOOHOHOOOHOOOHOHOH
OHHHOHHHOHOHHHHHOHHHOHHHOHOHHHHHOHOHOHOHOHOHHHOHOH
OOOHOOOOOHOHOOOHOOOHOOOHOOOHOOOHOHOOOHOHOHOHOOOOOH
OHOHHHHHHHOHOHHHHHOHHHHHHHOHOHOHHHOHHHOHHHOHOHHHHH
OHOOOOOOOHOHOOOOOHOHOOOOOOOHOHOOOHOOOOOHOOOHOOOOOH
OHHHHHHHOHOHOHOHOHOHOHHHHHHHOHHHOHHHHHOHOHHHHHHHOH
OHOOOHOOOHOHOHOHOHOOOHOOOOOHOHOHOHOOOOOHOHOOOOOOOH
OHHHOHOHOHOHHHOHOHHHHHOHHHOHOHOHOHOHHHHHOHHHHHHHHH
OOOOOHOHOHOOOOOHOHOOOOOOOHOHOHOOOHOOOOOHOOOOOOOOOH
HHHHOHOHOHHHHHHHOHOHHHHHOHOHOHOHHHHHHHHHHHHHHHHHOH
OOOOOHOHOOOHOOOOOHOOOOOHOHOHOHOOOOOOOOOOOOOOOOOHOH
HHHHHHOHHHOHOHHHHHHHHHHHOHHHOHHHHHHHHHHHHHHHHHOHOH
OOOOOOOHOOOHOHOOOOOOOHOOOHOOOHOOOOOOOOOOOHOOOHOHOH
OHHHHHHHHHHHOHOHHHOHOHOHOHOHHHHHHHHHHHOHOHHHOHOHOH
OOOHOOOOOHOOOHOHOOOHOOOHOHOHOOOOOHOOOOOHOOOOOHOOOH
OHOHOHHHOHOHHHHHOHHHOHHHHHOHOHHHOHOHHHHHHHHHOHHHOH
OHOOOOOHOHOHOOOHOHOHOHOOOHOHOOOHOOOHOOOOOOOHOOOHOH
OHHHHHHHOHOHOHOHOHOHOHOHOHOHOHOHHHHHHHHHHHOHHHOHOH
OHOOOOOHOHOHOHOOOHOOOHOHOOOHOHOHOOOHOOOOOHOHOOOHOH
OHOHHHOHOHOHOHHHHHOHHHOHHHHHOHOHOHOHOHHHOHOHOHHHOH
OHOHOHOHOHOOOHOOOHOHOHOHOOOHOHOOOHOOOOOHOHOOOHOOOH
HHOHOHOHOHHHHHOHHHOHOHOHOHOHHHHHHHOHHHHHOHOHHHOHHH
OOOHOOOHOOOOOOOOOOOOOHOHOHOHOOOOOHOHOHOOOHOOOHOOOH
OHHHOHHHOHHHHHHHHHHHHHOHOHOHOHHHOHOHOHOHHHHHHHHHOH
OHOOOHOOOOOHOOOOOOOOOHOOOHOOOOOHOHOHOHOOOOOOOOOOOH
OHOHHHHHHHHHOHHHHHHHOHOHHHHHHHHHOHOHOHHHHHHHHHHHHH
OHOOOHOOOOOOOHOOOHOOOHOOOHOOOOOOOHOHOOOOOOOOOOOOOH
OHHHOHOHHHHHHHOHHHOHHHHHOHOHHHHHHHOHHHOHOHHHHHHHHH
OHOOOOOHOOOOOHOOOOOHOOOOOHOHOOOOOHOOOHOHOOOOOOOOOH
OHHHHHHHOHHHOHOHHHHHOHHHHHOHOHHHOHHHOHHHHHHHHHOHOH
OHOOOOOHOHOHOOOHOOOHOOOHOHOHOHOOOOOHOOOOOOOOOHOHOH
OHOHHHOHOHOHHHHHHHOHHHOHOHOHOHHHHHHHHHHHHHHHOHHHOH
OHOHOOOHOOOHOOOOOOOOOHOOOHOHOOOOOOOOOOOOOOOHOHOOOH
OHOHOHHHHHOHOHHHHHHHHHOHHHOHOHHHHHHHOHHHHHOHOHOHOH
OOOHOHOOOHOHOOOOOHOOOOOHOOOHOHOOOHOOOHOOOOOHOHOHOH
OHHHOHHHOHOHOHHHOHOHHHHHOHHHOHOHOHOHHHHHHHHHOHOHOH
OHOGSOOHOOOHOOOHOOOOOHOHOOOHOHOHOHOOOOOOOOOOOHOHOH
OHOHOHOHOHHHHHHHHHHHOHOHHHOHHHOHOHOHHHHHHHHHHHOHHH
OHOHOHOHOHOOOOOHOOOHOOOOOHOOOOOHOHOOOOOHOOOOOHOOOH
OHOHHHOHOHHHOHOHOHOHHHHHHHHHHHHHOHHHHHOHOHHHOHHHOH
OHOOOOOHOOOOOHOOOHOOOOOOOOOOOOOOOHOOOOOOOHOOOOOOOH
HHHHHHHHHHHHHHHHHHHHHHHHHHHHHHHHHHHHHHHHHHHHHHHHHH
