OOOOOHOOOOOHOHOOOOOHOOOOOOOOOOOOOOOOOOOOOOOHOOOOOH
OHHHOHOHOHOHOHOHOHOHHHHHOHHHOHHHHHHHHHHHHHOHOHHHOH
OHOOOHOHOHOOOHOHOHOOOOOOOHOOOHOOOOOOOOOHOOOHOHOOOH
HHOHOHOHOHOHHHOHOHHHHHHHHHOHHHOHHHHHHHOHOHHHHHOHOH
OOOHOHOHOHOHOOOHOHOOOOOHOOOHOOOHOHOOOOOHOOOHOOOHOH
OHHHHHOHOHHHOHHHOHOHHHOHOHHHOHHHOHOHHHHHHHOHOHHHOH
OHOOOHOHOOOOOHOHOOOHOOOHOOOHOOOOOHOHOOOHOOOHOOOHOH
OHOHOHOHHHHHHHOHHHHHOHHHOHHHHHHHOHOHOHOHHHOHHHOHOH
OOOHOHOOOHOOOOOOOHOHOHOOOHOOOOOOOHOOOHOOOHOOOOOHOH
OHHHOHHHOHOHHHHHOHOHOHHHHHOHHHHHHHHHOHHHOHHHHHHHOH
OOOHOHOOOHOOOOOHOHOHOOOOOOOHOHOOOOOHOOOHOHOOOOOHOH
HHHHOHOHHHOHHHOHOHOHHHHHHHHHOHOHHHOHHHHHOHOHHHOHOH
OOOHOHOHOOOOOHOHOOOHOOOHOOOOOHOHOHOOOHOOOHOOOHOOOH
OHOHOHOHHHHHHHOHHHOHOHOHOHOHHHOHOHHHOHOHHHHHHHHHOH
OHOOOHOHOOOOOHOHOHOHOHOHOHOHOOOHOHOOOHOOOOOOOOOHOH
OHHHOHOHOHHHOHOHOHOHOHOHOHHHOHHHOHOHHHHHHHHHOHOHOH
OHOOOHOOOHOHOOOHOHOHOHOOOHOOOHOOOHOHOOOOOOOHOHOHOH
OHHHOHHHHHOHHHHHOHOHOHHHHHOHHHOHOHOHHHOHHHOHOHOHOH
OOOHOOOOOOOOOOOOOHOOOHOOOHOOOHOHOHOHOOOHOOOHOHOHOH
OHOHHHHHHHHHHHHHHHHHOHOHOHHHOHOHHHOHOHHHOHHHOHOHOH
OHOHOOOHOOOHOOOOOOOOOHOHOOOOOHOOOOOOOHOOOHOHOHOHOH
OHOHOHOHOHOHOHHHHHHHHHOHOHHHHHHHHHHHHHOHHHOHOHOHOH
OHOOOHOOOHOOOHOHOOOOOOOHOHOOOOOOOHOHOOOHOOOOOHOHOH
OHHHHHHHHHHHHHOHOHHHHHHHOHOHHHHHOHOHOHHHOHHHHHOHOH
OHOOOOOOOHOOOOOHOHOHOOOOOHOHOOOHOHOOOHOOOHOOOOOHOH
OHOHHHOHOHOHHHOHOHOHOHHHHHOHOHOHOHHHOHHHOHOHHHHHOH
OHOOOHOHOHOOOHOHOHOHOHOOOOOHOHOHOOOHOOOHOHOHOOOOOH
OHHHHHOHOHHHOHOHOHOHOHOHHHHHHHOHHHOHHHOHHHOHHHHHOH
OOOHOOOHOHOOOHOHOHOOOHOHOOOOOHOHOOOHOOOOOHOHOOOHOH
HHOHOHHHOHOHHHOHOHHHHHOHHHOHOHOHOHHHHHHHOHOHOHOHHH
OHOOOHOHOHOHOOOHOOOOOOOOOOOHOHOHOHOOOHOOOHOOOHOOOH
OHHHHHOHOHOHOHHHHHHHHHHHHHHHOHOHOHOHOHOHHHOHHHHHOH
OOOOOOOHOHOHOOOOOOOHOHOOOHOOOOOHOOOHOHOOOHOHOOOOOH
OHHHOHHHOHOHHHHHHHOHOHOHOHHHHHHHHHHHOHHHOHOHOHHHOH
OOOHOHOOOHOHOOOOOHOOOHOHOOOOOOOOOOOOOHOOOHOHOOOHOH
OHOHHHOHHHOHOHOHHHHHOHOHHHHHHHHHHHHHHHOHHHHHHHOHOH
OHOHOOOHOOOHOHOOOOOOOHOHOOOOOOOOOOOOOHOOOOOHOOOHOH
OHOHOHHHHHOHOHHHHHHHHHOHHHHHHHOHHHHHOHHHHHOHOHHHOH
OHOOOHOOOOOHOOOOOOOHOHOOOHOOOHOOOOOHOHOOOHOHOOOHOH
OHHHHHOHHHHHHHHHHHOHOHHHOHOHOHHHHHHHOHOHOHOHHHOHOH
OOOHOOOOOOOHOOOHOOOHOOOHOHOHOOOOOOOHOHOHOOOHOOOHOH
HHOHHHHHHHOHHHOHOHHHOHHHOHOHHHHHHHOHOHOHHHHHOHHHHH
OHOOOOOOOOOHOOOHOHOOOHOOOHOHOHOOOOOHOHOOOOOOOHOOOH
OHHHHHHHHHHHOHOHOHHHOHOHHHOHOHOHHHHHOHOHHHHHOHOHOH
OHOOOOOHOOOOOHOHOOOHOHOHOOOHOHOHOOOHOOOHOOOHOHOHOH
OHOHHHOHOHHHOHHHHHOHOHOHOHHHOHOHOHOHHHOHOHOHHHOHOH
OOOHOHOOOHOHOOOOOHOHOHOOOHOOOHOOOHOOOHOHOHOOOOOHOH
OHHHOHHHHHOHHHHHOHOHOHHHHHOHOHHHHHHHOHHHOHHHHHHHOH
OOOOOOOOOOOOOOOHOOOOOOOOOOOHOOOOOOOHOOOOSGOOOOOOOH
HHHHHHHHHHHHHHHHHHHHHHHHHHHHHHHHHHHHHHHHHHHHHHHHHH
