OOOOOHOOOOOOOOOOOOOOOHOOOHOOOOOOOOOOOOOOOHOHOOOOOH
OHHHOHOHHHHHHHHHOHHHOHOHHHOHHHHHHHHHHHOHOHOHOHOHHH
OOOHOOOOOOOHOOOOOHOOOHOOOHOHOOOHOOOOOOOHOHOOOHOOOH
HHHHHHHHHHOHOHHHHHOHHHOHOHOHOHOHOHHHHHHHOHHHHHHHOH
OOOOOOOOOHOHOOOHOHOHOOOHOOOHOHOOOHOOOOOOOHOOOOOHOH
OHHHHHHHOHHHHHOHOHOHHHHHOHHHOHHHHHHHHHOHHHOHHHOHOH
OHOOOOOHOHOOOOOHOHOOOOOHOOOHOHOOOOOOOHOOOOOHOOOHOH
OHHHOHOHOHOHHHHHOHHHHHOHHHHHOHOHHHHHOHHHHHHHOHHHOH
OOOHOHOHOHOHOOOOOHOOOOOHOOOHOHOHOOOHOOOHOOOHOOOHOH
OHOHHHOHOHOHHHOHHHOHHHHHOHOHOHOHHHOHHHOHOHHHHHOHOH
OHOOOHOHOOOHOOOHOOOHOOOOOHOOOHOOOOOHOOOHOOOOOHOOOH
OHHHOHOHHHHHOHHHOHHHOHHHOHOHHHOHHHHHOHHHOHOHHHHHOH
OHOHOHOOOOOHOOOOOHOOOOOHOHOHOOOHOOOOOHOHOHOOOOOOOH
OHOHOHOHOHHHOHHHHHOHHHHHOHHHOHHHOHHHHHOHOHHHHHHHHH
OHOHOHOHOOOOOHOOOOOHOHOOOHOOOHOHOHOOOOOHOHOOOOOOOH
OHOHOHHHHHHHOHOHHHHHOHOHOHOHHHOHOHOHOHOHOHOHHHHHOH
OHOHOOOOOOOHOHOOOOOOOHOHOHOOOHOHOHOHOHOHOOOHOHOOOH
OHOHHHHOHHOHOHHHHHHHOHOHHHHHOHOHOHOHOHHHHHHHOHOHHH
OHOOOOOOOHOHOOOHOOOOOHOOOHOOOOOHOHOHOHOOOOOHOOOHOH
OHOHHHHHHHOHHHOHOHHHHHOHOHOHHHHHOHHHOHOHOHHHOHHHOH
OHOHOOOOOOOHOOOHOHOOOHOHOOOHOOOOOHOOOHOHOOOOOHOOOH
OHOHOHHHHHHHOHHHHHOHOHOHHHHHOHHHHHOHHHOHHHHHOHHHOH
OOOHOHOOOHOOOOOOOOOHOHOOOOOHOOOHOOOOOOOHOOOHOOOOOH
OHHHOHOHHHOHHHHHHHHHOHOHHHHHHHOHOHHHHHHHOHOHHHHHOH
OHOOOHOOOHOHOOOHOHOOOHOHOOOOOHOHOHOOOOOHOHOOOHOHOH
HHOHHHHHOHOHOHOHOHOHHHOHOHHHOHOHOHOHHHOHOHHHOHOHOH
OOOHOOOHOOOHOHOHOOOHOOOHOHOOOHOHOHOOOHOHOOOHOHOHOH
OHHHOHOHOHHHOHOHOHHHHHOHOHOHHHOHHHHHOHOHHHOHOHOHOH
OHOOOHOHOOOHOHOHOOOOOHOHOHOOOHOOOOOOOHOOOOOHOHOOOH
OHOHHHOHHHHHOHOHHHHHOHOHOHHHOHOHHHHHHHHHHHHHOHHHHH
OHOOOHOOOOOHOHOHOOOHOHOHOHOOOHOOOOOOOHOOOOOHOOOOOH
OHHHOHHHHHOHOHOHOHOHOHHHOHOHHHHHHHHHOHOHHHOHHHHHOH
OOOHOHOOOHOHOHOHOHOOOOOOOHOOOOOHOOOHOHOOOHOHOOOOOH
OHHHOHOHHHOHOHOHOHHHHHHHHHHHHHOHOHOHHHHHOHOHOHHHHH
OOOHOOOHOOOHOHOHOOOHOOOOOHOOOHOHOHOHOOOOOHOHOOOOOH
HHOHHHOHOHOHOHOHHHHHOHHHOHOHOHOHOHOHOHHHHHOHOHHHOH
OOOOOHOHOHOHOHOOOOOOOHOHOHOHOOOOOHOHOHOOOHOHOHOOOH
OHHHHHOHOHOHOHHHHHHHHHHHOHHHHHHHHHOHOHOHHHOHOHOHOH
OOOOOOOHOHOHOHOOOHOOOOOHOHOOOHOHOOOHOHOOOHOHOHOHOH
OHHHHHHHOHHHOHOHHHOHOHHHHHHHOHOHOHHHOHHHOHOHHHOHOH
OOOHOHOOOHOOOHOOOOOHOHOOOOOOOHOOOHOOOHOOOHOOOHOHOH
HHOHOHOHOHOHHHHHHHHHOHOHHHHHHHOHHHHHOHOHHHHHOHOHHH
OHOHOHOHOHOOOHOOOOOOOHOOOHOHOOOHOOOOOHOOOOOHOHOOOH
OHOHOHOHOHHHOHOHHHHHHHHHOHOHOHHHHHOHHHOHHHOHOHOHOH
OHOOOHOHOOOHOHOHOOOOOHOOOHOHOHOOOHOHOOOHOHOOOHOHOH
OHHHOHOHHHHHGHOHOHHHOHOHHHOHOHOHOHOHOHHHOHHHHHHHOH
OOOOOHOOOOOOSHOOOHOHOOOHOOOHOOOHOOOHOHOOOOOOOOOOOH
OHHHHHHHHHOHHHOHHHOHHHHHOHHHHHHHHHHHOHHHOHHHHHHHOH
OOOOOOOOOHOOOOOHOOOOOOOOOOOOOOOOOOOOOOOOOHOOOOOOOH
HHHHHHHHHHHHHHHHHHHHHHHHHHHHHHHHHHHHHHHHHHHHHHHHHH
