OOOOOHOOOOGHOOOOOHOOSOOHOOOOOOOOOOOOOOOHOOOOOOOOOH
OHOHHHOHOHHHOHOHHHOHHHOHOHHHOHHHHHHHHHHHOHHHHHOHOH
OHOHOOOHOHOOOHOOOHOHOOOHOHOHOOOOOOOOOOOOOOOHOOOHOH
HHOHOHHHOHOHHHHHOHOHOHHHOHOHHHHHHHHHHHHHHHHHOHHHOH
OOOHOOOHOHOHOOOOOHOHOOOHOHOOOOOOOOOHOOOOOOOHOOOHOH
OHOHHHOHOHOHOHHHHHOHHHOHOHHHOHHHHHOHOHHHHHOHOHOHHH
OHOHOOOHOOOHOOOOOHOOOHOHOHOOOHOOOOOHOHOOOHOHOHOOOH
OHHHOHHHHHHHHHHHOHHHOHOHOHOHHHOHHHHHOHOHOHOHHHHHOH
OOOHOHOHOOOOOOOHOOOOOHOOOOOHOOOOOHOOOHOHOOOHOOOHOH
HHOHOHOHOHOHHHOHHHHHHHHHHHHHOHHHHHOHHHOHHHHHOHOHOH
OOOHOHOOOHOOOHOHOOOOOHOOOOOHOHOOOHOHOOOHOOOOOHOHOH
OHHHOHHHHHHHOHOHOHHHOHOHHHOHHHOHOHOHOHHHOHHHHHOHOH
OOOHOHOOOOOOOHOHOHOOOHOOOHOOOHOHOOOHOHOOOOOOOHOOOH
HHOHOHOHHHHHHHOHOHOHHHHHOHHHOHOHHHHHOHOHHHHHOHHHOH
OOOHOOOHOOOOOOOHOHOOOOOOOHOHOOOHOHOOOHOOOOOHOOOHOH
OHHHHHHHOHHHHHHHOHHHHHHHHHOHHHHHOHOHHHOHHHHHHHOHOH
OOOOOOOHOOOHOOOHOOOHOOOOOOOHOOOOOHOOOHOHOOOOOOOHOH
OHOHHHHHHHOHOHOHHHOHOHHHHHOHOHHHOHHHOHHHOHHHHHHHOH
OHOOOOOOOHOOOHOOOOOHOHOOOHHOOOOHOOOHOOOOOHOOOOOHOH
OHHHHHHHOHHHHHHHHHHHOHHHOHHHHHHHOHHHHHHHHHOHHHOHOH
OHOOOOOHOOOHOOOOOOOHOOOOOHOHOOOOOHOOOHOOOOOHOOOHOH
OHHHOHOHOHHHOHOHHHHHOHHHOHOHOHHHHHOHOHOHOHHHHHHHOH
OHOOOHOHOOOHOHOHOOOOOHOOOHOHOOOOOHOHOHOHOOOOOHOOOH
OHOHHHOHHHOHOHOHOHHHOHOHHHOHHHHHOHOHOHOHHHHHOHOHHH
OOOHOHOOOHOHOHOOOHOOOHOHOOOOOOOHOOOHOHOOOHOHOHOHOH
HHHHOHHHHHOHOHHHHHOHHHOHOHOHHHOHHHHHOHHHOHOHOHHHOH
OOOHOOOOOHOHOHOOOHOOOOOHOHOOOHOOOOOHOOOHOHOHOOOHOH
OHHHOHHHHHOHOHOHHHHHHHHHHHHHOHHHHHOHHHOHOHOHHHHHOH
OOOOOHOOOOOHOHOOOOOOOOOOOOOOOHOOOHOOOHOHOHOOOOOHOH
HHHHHHOHHHOHOHOHHHHHOHOHHHHHHHOHOHHHOHOHOHOHHHOHOH
OOOHOOOHOHOHOHOOOHOOOHOHOOOHOOOHOHOOOHOOOHOHOOOHOH
OHOHOHHHOHOHOHHHOHOHHHHHOHOHHHOHOHOHHHHHHHOHOHHHOH
OHOHOHOHOOOHOOOHOHOHOOOOOHOOOHOHOOOHOOOOOOOHOOOOOH
OHOHOHOHOHHHHHOHOHOHOHHHHHHHOHOHHHHHOHHHHHHHHHHHOH
OHOOOHOOOHOOOOOHOHOOOHOOOHOOOHOHOOOHOHOOOHOOOOOOOH
OHHHHHOHHHOHHHHHHHOHHHOHOHOHHHOHOHOHOHOHOHHHHHOHHH
OOOHOOOHOOOHOOOOOHOHOHOHOOOHOOOHOHOHOOOHOOOOOHOHOH
OHHHHHHHOHHHOHHHOHOHOHOHHHHHHHOHOHOHHHOHHHHHOHOHOH
OHOOOHOOOHOOOHOOOHOOOHOOOOOOOHOOOHOOOHOOOOOHOHOOOH
OHHHOHOHHHHHOHOHHHHHHHOHHHHHOHHHHHHHOHHHHHHHOHHHOH
OHOHOHOOOOOOOHOOOOOOOHOOOHOOOHOOOOOHOHOOOOOOOHOOOH
OHOHOHHHHHHHHHHHHHHHOHHHHHOHHHOHHHHHOHOHHHHHHHOHHH
OOOHOOOOOOOHOOOHOOOHOOOOOHOOOHOOOOOOOHOOOHOOOHOOOH
HHOHOHHHHHOHOHOHHHOHHHHHOHHHOHOHHHHHHHHHOHOHOHHHOH
OOOHOOHOOHOOOHOOOHOHOOOHOHOOOHOHOOOOOOOOOHOHOOOHOH
OHHHHHHHOHHHHHHHOHOHOHOHOHOHHHOHOHHHHHHHHHOHOHHHOH
OHOOOOOOOHOOOOOHOOOHOHOHOOOHOHOHOOOHOHOOOOOHOOOHOH
OHOHHHHHHHOHHHOHHHHHOHOHHHHHOHOHHHOHOHOHHHHHHHOHOH
OHOOOOOOOOOOOHOOOOOOOHOOOOOOOOOOOOOHOOOOOOOOOHOOOH
HHHHHHHHHHHHHHHHHHHHHHHHHHHHHHHHHHHHHHHHHHHHHHHHHH
