OOOOOHOOOOOOOOOOOHOOOHOOOOOOOHOOOOOOOOOHOOOOOOOOOH
HHOHOHOHHHHHHHOHHHOHOHOHHHHHOHOHHHHHOHOHHHOHHHOHOH
OOOHOOOHOOOOOOOHOOOHOOOOOOOHOOOHOOOHOHOOOHOHOOOHOH
OHHHHHOHHHHHOHHHOHHHHHHHHHOHHHHHOHOHOHHHOHOHOHHHOH
OOOOOHOHOOOHOHOOOHOOOOOHOHOHOOOOOHOHOHOOOHOHOHOHOH
OHHHOHHHOHOHHHOHHHOHHHOHOHOHOHHHHHOHOHHHOHHHOHOHOH
OOOHOOOOOHOHOOOHOHOHOOOHOHOHOHOOOOOHOOOHOHOOOHOOOH
OHHHHHHHHHOHOHHHOHOHHHOHOHOHOHOHHHHHHHOHOHOHHHOHHH
OHOOOOOOOOOHOOOHOHOOOHOHOOOOOHOOOOOHOOOHOOOHOHOHOH
OHOHHHHHHHHHHHOHOHHHOHOHHHOHHHHHHHHHOHHHHHHHOHOHOH
OHOOOOOOOOOOOOOHOHOOOHOOOHOHOOOOOOOHOOOOOHOOOHOHOH
OHHHHHHHHHHHHHHHOHOHHHHHOHHHOHHHHHOHHHHHOHOHOHOHOH
OHOOOOOHOOOOOHOOOHOOOOOHOHOOOHOOOHOHOOOOOHOHOHOHOH
OHOHOHOHHHOHOHOHHHHHHHOHOHOHHHHHOHOHOHHHHHHHOHOHOH
OHOHOHOOOOOHOHOOOOOHOOOHOOOHOOOOOHOOOHOOOOOOOHOHOH
OHHHOHOHHHHHOHHHOHOHOHHHHHHHOHHHHHHHHHOHHHHHOHOHOH
OOOOOHOHOOOHOOOOOHOHOOOHOOOOOOOOOOOOOOOHOOOHOHOHOH
HHHHHHOHOHOHHHHHOHHHHHOHOHHHHHHHHHHHHHOHOHOHOHOHOH
OOOHOOOHOHOOOHOOOHOOOOOHOHOOOOOOOHOOOOOHOHOOOHOHOH
HHOHOHHHOHHHOHOHHHOHHHHHOHOHHHHHOHOHHHHHHHHHHHOHOH
OOOHOHOOOHOOOHOOOHOOOHOOOHOHOOOHOHOOOHOOOOOOOHOHOH
OHHHOHOHHHOHHHHHOHHHOHOHHHOHOHOHOHHHOHOHHHHHOHOHOH
OOOOOHOHOOOOOOOHOOOHOHOHOOOHOHOHOOOHOHOOOHOOOHOOOH
OHHHHHOHHHHHHHOHHHHHOHOHOHHHOHOHHHOHOHOHHHOHHHHHOH
OHOOOHOOOOOHOOOOOOOOOHOHOHOOOHOOOHOHOOOHOOOHOOOHOH
OHHHOHHHHHOHHHHHHHHHHHOHOHOHHHHHOHOHHHHHOHHHOHOHOH
OOOOOOOOOHOOOOOOOOOHOOOHOOOHOOOOOHOOOOOOOHOOOHOOOH
HHHHOHHHHHOHHHHHHHOHOHHHHHHHOHHHHHOHHHHHHHOHHHHHHH
OHOOOHOOOHOHOOOOOOOHOOOOOOOHOHOOOOOHOOOOOOOHOOOOOH
OHOHHHOHOHOHOHHHHHHHHHHHHHOHOHOHHHHHOHHHHHHHHHHHOH
OHOOOHOHOHOHOHOHOOOOOOOHOOOHOHOHOOOOOHOOOOOOOOOOOH
OHHHOHOHOHHHOHOHOHHHOHHHOHHHOHHHOHHHHHHHOHHHHHHHOH
OOOOOHOHOOOOOHOOOOOHOOOHOOOHOOOHOHOOOOOOOHOOOHOHOH
HHHHOHOHHHHHHHHHHHHHHHOHHHOHHHOHOHOHHHHHHHOHOHOHOH
OOOHOHOHOOOOOOOOOOOOOHOHOOOHOHOOOHOOOHOOOOOHOOOHOH
OHOHHHOHOHHHHHHHHHHHOHOHOHHHOHHHHHHHOHOHHHOHHHOHOH
OHOOOHOHOOOOOOOOOHOHOHOHOOOHOOOOOOOOOHOHOHOHOOOHOH
OHHHOHOHHHHHHHHHOHOHOHOHHHOHHHOHHHHHHHOHOHOHHHHHOH
OHOOOHOHOOOOOHOOOHOOOOOOOHOOOOOHOOOHOHOHOHOOOOOOOH
OHHHOHOHOHHHOHOHHHOHHHHHHHHHHHHHOHOHOHOHOHHHHHHHHH
OOOHOOOHOOOHOHOOOHOOOHOOOOOOOOOOOHOOOHOHOOOOOOOOOH
HHOHHHOHHHOHOHHHOHHHOHOHHHHHOHHHOHHHHHOHOHHHHHHHOH
OOOHOOSOOOOHOHOOOHOOOHOOOHOOOHOOOHOOOOOHOHOOOOOOOH
OHHHOHHHHHHHOHOHHHOHHHHHOHOHHHHHHHOHHHHHHHOHHHHHOH
OHGOOOOOOHOOOHOOOHOHOOOHOHOHOOOOOHOOOOOOOOOHOHOOOH
OHHHHHHHHHOHHHOHOHHHOHOHOHOHOHHHOHHHHHHHHHHHOHOHHH
OOOOOOOOOOOHOOOHOHOOOHOHOHOHOOOHOOOOOHOOOOOOOHOOOH
HHHHHHHHHHHHOHHHOHOHHHOHOHOHHHOHHHHHOHOHHHOHHHHHOH
OOOOOOOOOOOOOOOHOOOOOHOOOHOOOOOOOOOHOOOOOHOOOOOOOH
HHHHHHHHHHHHHHHHHHHHHHHHHHHHHHHHHHHHHHHHHHHHHHHHHH
