OOOOOOOHOHOOOOOOOOOOOHOOOOOOOHOOOOOOOOOOOOOHOOOOOH
OHHHHHOHOHOHHHHHHHHHOHOHOHHHHHOHOHHHHHHHHHOHOHOHHH
OOOOOHOOOHOHOOOHOOOHOOOHOOOOOOOHOOOHOOOOOOOHOHOOOH
OHHHOHHHHHOHOHOHOHOHHHHHOHHHHHHHHHOHOHHHHHHHOHHHOH
OOOHOHOOOHOHOHOOOHOHOOOHOOOHOOOOOHOHOHOOOOOHOHOOOH
HHOHOHOHOHOHOHHHOHHHOHOHHHOHHHOHHHOHOHHHOHOHHHOHHH
OOOHOHOHOOOOOHOOOHOOOHOOOHOHOOOHOOOHOOOOOHOOOHOOOH
OHHHOHOHHHHHHHOHHHOHHHHHOHOHOHOHOHHHHHHHHHHHOHOHOH
OHOHOHOOOHOOOHOOOHOOOHOOOHOOOHOHOHOOOOOOOHOOOHOHOH
OHOHOHOHHHOHOHHHHHHHOHOHHHOHHHHHOHOHHHOHHHOHHHHHOH
OHOHOHOHOOOHOOOOOOOOOHOOOHOHOOOOOHOHOOOHOOOHOOOOOH
OHOHOHOHOHHHHHHHHHHHHHHHOHHHOHHHHHHHOHHHOHHHOHHHOH
OHOHOHOHOHOOOHOOOOOOOOOHOOOHOHOOOOOHOOOOOHOOOHOOOH
OHOHOHOHOHHHOHOHHHHHHHOHHHOHOHOHHHOHOHHHHHHHOHOHHH
OOOHOOOHOOOHOHOOOHOOOHOHOOOHOHOOOHOHOOOOOOOOOHOOOH
HHOHHHHHHHOHOHHHOHOHOHOHOHHHOHOHHHOHHHHHHHHHHHHHOH
OHOOOHOOOOOHOOOHOHOHOHOHOHOOOOOHOOOHOOOOOOOOOHOOOH
OHHHOHOHHHHHOHOHOHOHOHOHOHHHHHHHOHHHOHHHHHHHOHOHHH
OOOOOHOHOOOOOHOHOOOHOHOHOOOHOOOHOOOHOOOHOOOOOHOOOH
OHHHHHOHHHHHHHOHHHHHOHOHHHOHOHOHHHOHHHOHHHHHHHHHOH
OOOOOHOHOOOHOOOHOOOHOHOOOHOOOHOOOHOOOHOOOHOOOHOOOH
OHHHHHOHOHOHOHOHHHOHOHOHHHHHHHHHOHHHOHHHOHOHOHOHHH
OHOOOOOHOHOOOHOOOOOHOHOOOOOOOOOHOOOHOOOHOOOHOHOOOH
OHOHHHHHOHHHHHHHHHOHOHHHHHHHHHOHHHOHOHOHHHOHOHHHOH
OHOHOHOOOHOHOOOOOOOHOHOOOOOOOHOOOOOHOHOOOHOHOOOOOH
HHOHOHOHOHOHOHHHHHHHOHOHHHHHOHHHHHHHOHHHOHHHOHHHHH
OOOHOOOHOHOOOOOOOHOOOHOHOOOOOHOOOOOHOHOHOOOHOOOOOH
OHHHOHHHOHHHHHHHOHOHHHHHOHHHOHOHHHOHOHOHHHOHHHHHOH
OHOHOHOHOHOOOOOHOHOHOOOHOHOOOHOHOHOHOOOOOHOOOOOHOH
OHOHOHOHOHOHHHOHHHOHOHOHOHOHHHOHOHOHHHHHOHHHHHOHOH
OHOHOHOHOOOHOHOHOOOHOHOOOHOHOHOHOHOOOOOHOOOOOHOHOH
OHOHOHOHHHHHOHOHOHHHOHHHHHOHOHOHOHOHHHOHHHHHOHOHHH
OHOOOOOOOOOOOHOOOHOOOHOOOOOOOHOOOHOOOHOOOHOOOHOOOH
OHHHHHHHHHHHOHHHHHHHOHHHHHHHHHHHOHHHOHHHOHOHHHHHOH
OHOOOOOHOOOHOHOOOOOHOOOOOOOOOOOHOOOHOOOHOHOHOOOHOH
OHOHHHOHHHOHOHOHHHOHHHHHOHHHOHHHHHOHHHOHHHOHHHOHOH
OHOHOHOOOHOOOOOHOHOHOOOHOOOHOOOOOHOOOHOHOOOHOOOHOH
OHOHOHHHOHHHHHHHOHOHOHOHHHOHHHOHHHHHOHOHOHHHOHOHOH
OHOHOOOHOOOOOHOOOHOOOHOHOOOHOOOHOOOOOHOOOHOOOHOHOH
OHOHHHOHHHHHOHOHHHHHHHOHOHHHOHHHOHHHHHHHOHOHHHOHOH
OHOOOHOOOOOHOHOOOOOOOHOHOHOHOOOHOOOHOOOHOOOHOHOHOH
OHHHOHOHHHOHOHHHOHHHHHOHOHOHHHOHOHHHOHOHHHHHOHOHOH
OOOHOHOOOHOOOOOHOOOOOOOHOOOOOHOOOHOOOHOOOHOOOOOHOH
OHOHOHHHOHOHHHOHOHHHHHHHOHHHHHHHHHOHHHHHOHHHHHHHOH
OHOHOHOOOHOOOHOHOOOOOHOOOHOOOOOOOHOOOHOHOOOOOHOOOH
OHOHOHOHHHHHOHOHHHHHOHHHHHOHHHHHOHHHOHOHHHHHOHOHOH
OHOOOHOHOHOOOHOOOHOHOHOOOHOHOOOHOOOOOHOHOOOHOOOHOH
OHHHHHOHOHHHHHHHOHOHOHOHOHOHOHOHHHHHHHOHOHOHHHHHOH
OOOOOOOHSGOOOOOOOHOOOOOHOOOHOHOOOOOOOOOOOHOOOOOOOH
HHHHHHHHHHHHHHHHHHHHHHHHHHHHHHHHHHHHHHHHHHHHHHHHHH
