OOOHOOOOOOOOOOOOOHOOOHOOOOOOOOOOOOOOOOOHOOOHOOOOOH
OHOHOHHHHHHHOHHHHHHHOHOHHHHHHHOHHHHHHHOHOHOHOHHHOH
OHOHOOOHOOOHOOOOOOOHOHOOOOOOOHOOOHOOOOOOOHOHOOOHOH
OHHHHHOHOHOHHHHHHHOHHHHHOHHHHHHHOHOHHHHHHHOHOHOHHH
OOOOOOOHOHOHOOOOOHOOOOOHOHOOOOOOOHOHOOOHOOOHOHOOOH
OHHHHHHHOHOHOHHHOHHHOHHHOHOHHHHHOHHHOHOHOHOHHHHHOH
OHOOOOOOOHOHOHOOOOOHOOOHOHOOOHOOOHOOOHOHOOOOOOOOOH
OHOHHHHHHHOHHHOHHHOHHHOHOHHHOHHHHHOHHHOHOHHHHHHHOH
OHOHOOOOOHOOOOOHOOOHOHOOOOOHOOOHOOOOOHOHOHOOOHOOHH
OHOHOHOHHHHHHHHHOHHHOHHHHHHHHHOHOHHHHHOHHHOHOHOHHH
OHOHOHOOOOOOOOOHOOOOOOOHOOOOOOOHOHOHOOOHOOOHOHOOOH
OHOHHHHHHHHHOHHHHHHHHHOHOHHHHHHHOHOHOHHHOHHHOHHHOH
OHOOOHOOOOOHOOOHOOOOOHOHOOOOOOOOOHOHOOOHOHOOOHOOOH
OHHHOHOHHHOHHHOHOHHHOHOHHHHHHHHHHHOHHHOHOHOHHHHHHH
OOOOOHOOOHOOOOOHOHOOOHOOOHOOOOOHOOOOOHOOOHOOOOOOOH
HHHHHHOHOHHHHHHHOHOHHHHHOHOHHHOHOHHHHHHHHHHHHHOHOH
OHOOOHOHOOOOOHOOOHOHOOOHOHOOOHOHOHOOOOOOOOOOOHOHOH
OHOHOHOHHHHHOHOHHHOHOHOHOHHHOHOHOHOHHHHHHHHHOHHHOH
OOOHOOOHOOOOOHOOOHOHOHOOOHOOOHOOOHOHOOOOOHOOOHOOOH
HHHHHHHHOHHHHHOHHHOHOHHHHHOHHHHHOHOHHHHHOHOHHHOHOH
OOOOOOOOOHOOOOOHOOOHOOOHOOOOOOOHOHOOOOOHOHOOOOOHOH
OHHHHHOHHHOHHHHHOHOHHHOHOHHHHHOHHHHHHHOHOHHHHHHHOH
OOOOOHOHOOOOOHOOOHOOOHOHOHOOOOOHOOOOOHOHOOOOOOOHOH
HHHHOHOHOHHHHHOHOHHHHHOHOHOHHHHHOHOHOHOHOHHHOHHHOH
OOOOOHOHOOOHOOOHOHOOOHOHOHOOOOOOOHOHOHOHOOOHOOOOOH
OHHHOHHHHHOHOHHHOHOHOHOHHHOHHHHHHHOHOHOHHHHHHHOHHH
OOOHOHOOOOOHOHOOOHOHOHOOOHOHOOOOOOOHOHOOOOOOOHOOOH
HHOHHHOHHHHHOHOHHHOHOHHHOHHHOHHHHHHHHHHHHHHHOHHHOH
OOOHOOOHOHOOOHOHOOOHOOOHOHOOOHOOOHOOOOOOOHOHOOOHOH
OHHHOHHHOHOHOHHHOHHHHHOHOHOHHHOHOHOHHHOHOHOHHHOHOH
OOOOOOOOOHOHOHOOOHOOOHOHOHOHOOOHOOOOOHOHOHOOOHOHOH
HHHHHHHHHHOHHHOHHHOHOHOHOHOHOHHHHHHHOHOHOHOHOHOHOH
OOOOOHOOOHOOOHOHOOOHOHOOOHOOOHOOOOOHOHOHOHOHOHOHOH
OHHHOHOHOHHHOHOHHHOHHHHHHHOHHHOHHHOHOHOHOHOHOHOHHH
OOOHOOOHOOOOOHOOOHOOOOOHOOOHOOOHOOOHOHOHOOOHOHOOOH
OHOHOHHHHHHHHHHHOHHHOHOHHHHHOHHHOHHHHHOHHHHHHHHHOH
OHOHOHOOOOOHOOOHOOOOOHOOOHOOOHOHOHOOOHOOOOOHOOOHOH
HHOHOHOHHHOHOHOHHHHHHHHHOHOHHHOHOHOHOHOHHHOHOHOHOH
OOOHOHOHOHOOOHOOOOOOOOOHOHOOOHOHOOOHOHOHOHOHOHOHOH
OHHHHHOHOHHHHHOHHHHHHHOHOHHHOHOHHHHHOHOHOHOHOHOHOH
OHOOOHOHOOOHOOOHOOOOOHOHOOOHOHOOOOOHOHOOOHOHOHOOOH
OHOHOHOHHHOHOHHHOHHHOHOHHHOHOHHHOHOHOHHHHHOHOHHHHH
OHOHOHOHOOOHOOOHOOOHOOOOOHOOOHOOOHOHOOOHOGSOOHOOOH
OHOHOHOHOHHHHHOHOHHHHHHHHHHHHHOHHHOHHHOHOHOHHHHHOH
OOOHOOOHOOOOOHOHOHOOOOOOOOOOOOOHOOOOOHOHOHOHOOOOOH
OHHHHHHHHHOHHHOHHHOHHHHHHHHHOHHHHHHHHHOHOHOHOHHHOH
OOOOOHOOOHOOOHOHOOOHOOOOOOOHOOOHOOOOOOOHOHOHOHOHOH
HHHHOHOHOHHHOHOHOHHHOHHHHHOHHHOHOHHHHHHHOHOHOHOHOH
OOOOOOOHOOOOOHOOOOOOOHOOOOOOOHOOOOOOOOOOOHOOOHOOOH
HHHHHHHHHHHHHHHHHHHHHHHHHHHHHHHHHHHHHHHHHHHHHHHHHH
