OOOOOHOHOOOOOOOOOOOOOHOHOOOOOOOHOOOOOOOOOOOHOOOOOH
HHOHOHOHOHHHOHHHHHHHOHOHOHOHHHOHHHHHOHHHOHOHOHOHOH
OOOHOHOHOHOOOHOOOHOOOHOOOHOOOHOOOOOHOOOHOHOHOHOHOH
OHHHOHOHOHOHHHOHOHOHHHOHHHHHOHHHHHOHHHHHOHOHOHOHHH
OHOOOHOHOHOHOOOHOOOHOOOOOOOHOOOHOOOHOOOHOHOHOHOOOH
OHOHHHOHOHOHOHHHHHHHHHHHHHHHHHOHOHHHOHOHOHOHHHHHOH
OHOOOOOHOHOHOHOOOHOOOOOOOOOHOOOHOOOOOHOOOHOOOOOHOH
OHHHHHHHOHOHOHOHOHOHHHHHHHOHOHHHHHHHHHHHHHHHHHOHOH
OHOOOOOOOHOHOOOHOOOHOOOOOHOOOHOOOHOHOOOOOOOOOHOHOH
OHOHHHHHHHOHHHHHHHHHOHHHHHHHHHOHOHOHOHHHOHHHOHOHOH
OOOOOHOOOOOHOOOOOHOOOOOOOOOOOOOHOOOHOOOHOOOHOHOHOH
OHHHHHOHHHHHOHOHHHOHHHHHHHHHHHOHOHHHHHOHHHOHOHOHOH
OHOOOHOHOOOHOHOOOOOHOOOOOOOOOHOHOHOOOOOHOHOHOHOOOH
HHOHOHOHHHOHOHHHHHHHHHHHHHHHOHOHOHOHHHHHOHOHHHHHOH
OOOHOHOOOHOHOOOHOOOOOOOOOOOHOHOHOHOHOOOOOHOOOOOOOH
OHHHOHHHOHOHHHOHHHOHHHHHHHOHOHOHOHOHHHHHOHHHHHHHHH
OOOHOOOOOHOOOHOOOHOHOOOHOOOHOHOHOHOOOOOOOOOHOOOHOH
OHOHOHHHHHHHOHHHOHOHOHOHOHHHOHOHOHHHHHHHHHOHOHOHOH
OHOHOHOOOOOHOOOHOOOHOHOHOHOOOHOHOOOHOOOHOHOOOHOOOH
OHOHHHOHHHOHHHOHHHHHOHOHOHHHOHOHHHOHOHOHOHHHHHHHOH
OHOOOHOHOHOOOHOOOOOOOHOHOOOHOHOHOHOHOHOHOOOOOHOOOH
OHHHOHOHOHHHOHOHOHHHHHOHHHOHOHOHOHOHOHOHOHHHOHOHHH
OHOOOHOHOOOHOHOHOHOOOHOOOHOOOHOHOHOOOHOHOHOOOHOOOH
OHOHHHOHHHOHOHOHHHOHOHHHOHHHOHOHOHHHHHOHOHOHOHHHOH
OHOOOOOOOOOHOHOOOOOHOOOHOHOOOHOHOOOHOOOHOHOHOOOHOH
HHHHHHHHHHOHOHOHHHHHHHOHHHOHHHOHHHOHOHHHHHOHHHOHOH
OOOOOOOHOOOHOHOHOOOOOHOOOOOHOOOHOOOHOHOOOHOOOHOHOH
OHHHHHOHHHOHOHHHOHHHOHOHHHHHOHHHOHHHOHOHOHHHOHHHOH
OOOHOHOOOHOHOOOOOHOOOHOOOHOOOHOOOHOOOOOHOOOHOHOOOH
HHOHOHHHOHHHHHHHHHOHHHOHHHOHHHHHOHOHHHHHHHOHOHOHHH
OOOHOOOHOOOHOOOOOOOHOOOHOOOHOOOHOOOHOOOOOHOOOHOHOH
OHHHOHHHHHOHOHOHHHHHHHHHOHHHOHOHHHHHOHHHOHHHHHOHOH
OOOHOOOOOHOHOHOHOOOOOOOHOOOHOHOOOOOOOOOHOHOOOOOHOH
HHOHOHOHHHOHOHOHOHHHHHOHHHOHOHHHHHHHHHHHOHOHHHHHOH
OOOHOHOOOOOOOHOHOHOOOOOOOHOOOOOOOHOHOOOOOHOOOHOOOH
OHHHHHHHHHHHHHHHOHHHHHHHOHHHHHHHOHOHOHHHHHHHOHHHOH
OOOHOOOOOOOOOOOHOOOOOOOHOOOHOOOHOOOHOOOHOOOOOHOOOH
HHOHOHHHHHHHHHOHHHHHHHOHHHOHHHOHHHOHHHOHOHHHHHOHHH
OOOHOHOOOHOOOOOHOOOOOHOHOOOHOOOHOOOOOHOHOHOOOOOOOH
OHOHOHOHOHOHHHHHOHHHOHGHOHHHOHHHOHHHHHOHOHHHHHOHOH
OHOHOOOHOHOOOOOHOHOHOOSHOHOOOOOOOOOHOOOHOOOOOHOHOH
OHHHHHHHOHHHHHOHOHOHHHOHOHOHHHHHHHHHOHHHHHHHOHHHOH
OOOOOOOHOOOOOHOOOHOOOHOOOHOOOHOOOOOOOHOOOOOHOHOOOH
HHOHHHHHHHHHOHHHHHOHOHHHHHHHOHOHHHHHHHOHHHOHOHOHOH
OHOOOOOOOOOOOHOHOOOHOOOOOOOOOHOHOOOOOHOHOHOHOOOHOH
OHHHHHHHHHHHHHOHOHHHHHHHHHHHHHOHOHHHOHOHOHOHHHHHOH
OHOOOOOOOHOOOOOHOOOHOOOHOOOOOOOHOHOHOOOHOHOOOOOHOH
OHOHHHHHOHOHOHHHHHOHOHOHOHHHHHHHOHOHHHHHOHHHOHHHOH
OOOOOOOHOOOHOOOOOOOOOHOHOOOOOOOOOOOOOOOOOOOHOOOOOH
HHHHHHHHHHHHHHHHHHHHHHHHHHHHHHHHHHHHHHHHHHHHHHHHHH
