OOOHOOOOOOOOOOOOOOOOOOOHOOOHOOOHOOOOOHOOOOOOOOOHOH
OHOHOHHHHHHHOHHHHHHHHHOHOHOHOHOHOHOHOHOHHHOHHHOHOH
OHOOOOOOOHOOOHOOOHOOOOOHOHOOOHOOOHOHOHOHOHOOOHOOOH
OHHHHHHHHHOHHHOHHHOHHHHHOHHHHHHHOHOHHHOHOHHHOHHHHH
OHOOOHOOOHOOOHOOOOOHOHOOOHOOOOOHOHOOOOOHOOOHOHOOOH
OHOHOHOHOHHHOHHHOHHHOHOHHHOHHHOHOHHHHHHHHHOHOHOHOH
OHOHOHOHOOOHOOOHOHOOOOOHOOOHOOOHOHOOOOOOOOOHOOOHOH
OHOHOHOHHHOHOHOHOHHHHHHHOHHHOHHHOHHHOHHHHHOHHHHHOH
OHOHOOOHOHOHOHOHOOOOOOOHOHOHOOOHOOOHOOOHOHOHOOOHOH
OHOHHHHHOHOHOHOHHHHHHHOHOHOHHHOHHHOHHHOHOHOHOHOHOH
OHOHOHOOOOOHOHOOOOOOOHOOOHOHOOOHOOOOOOOHOHOHOHOHOH
HHOHOHOHHHHHOHHHHHHHOHHHHHOHOHHHHHHHHHHHOHOHHHOHOH
OOOHOHOOOOOHOHOOOOOHOHOHOOOHOHOOOHOOOHOOOHOHOOOHOH
OHHHOHHHHHOHOHOHOHHHOHOHOHOHOHOHOHHHOHOHOHOHOHOHOH
OOOHOHOOOOOHOOOHOHOOOHOHOHOOOHOHOOOHOHOHOOOOOHOHOH
HHOHOHOHHHHHHHHHHHOHHHOHOHHHHHOHHHOHOHOHHHHHHHHHOH
OOOHOOOOOOOOOOOOOOOHOHOOOHOOOOOHOOOHOOOHOHOOOOOHOH
OHHHHHHHHHHHHHHHHHHHOHOHHHHHHHOHHHOHHHOHOHOHHHOHOH
OOOHOOOHOOOOOOOOOHOOOOOOOHOOOHOOOHOOOHOOOHOOOHOHOH
HHOHOHOHOHHHHHHHOHHHHHHHOHOHOHHHOHHHOHOHHHHHOHOHOH
OOOHOHOOOHOOOOOHOOOOOHOOOOOHOOOOOHOHOHOHOOOOOHOOOH
OHHHOHHHHHHHHHOHHHHHOHHHHHHHOHHHHHOHOHHHOHHHHHHHHH
OHOOOHOOOHOOOHOOOOOHOOOOOHOOOHOOOHOOOOOOOHOOOOOOOH
OHOHHHOHOHOHOHHHHHOHHHHHOHHHOHOHOHHHHHHHHHOHHHHHOH
OOOHOOOHOOOHOOOHOOOOOOOHOOOHOHOHOOOOOOOOOOOOOHOOOH
OHHHOHHHHHHHHHOHOHOHHHHHOHOHHHOHHHHHHHHHHHHHHHOHOH
OOOOOHOOOHOOOOOHOHOHOOOHOHOOOHOOOHOOOOOOOHOOOOOHOH
HHHHHHOHHHOHHHHHOHOHOHOHHHHHOHHHOHHHOHHHOHOHHHHHHH
OOOOOOOHOOOHOOOOOHOHOHOOOOOOOOOHOOOOOHOHOHOOOOOOOH
OHOHHHHHOHHHOHHHOHHHOHHHHHHHHHHHHHHHHHOHOHHHHHHHOH
OHOHOOOHOOOHOOOHOOOHOOOOOOOOOHOOOOOOOOOHOOOOOOOHOH
OHHHOHOHHHOHHHOHHHOHHHHHHHHHOHOHHHOHHHOHHHHHOHHHOH
OHOOOHOHOOOHOHOOOHOOOHOOOOOHOOOHOOOHOHOOOHOOOHOOOH
OHOHHHOHOHHHOHHHOHHHOHOHOHHHHHHHOHHHOHHHOHOHHHOHHH
OHOOOHOHOHOOOOOHOHOHOOOHOOOOOHOOOHOOOOOOOHOHOHOOOH
OHHHOHOHOHOHOHHHOHOHHHHHHHOHOHOHHHOHHHHHHHOHOHHHOH
OHOOOHOHOHOHOOOOOOOHOOOHOOOHOHOHOOOOOHOOOHOOOHOHOH
OHOHHHOHOHOHHHHHHHOHOHOHOHHHHHOHHHHHHHOHOHHHOHOHOH
OOOHOHOOOHOOOHOOOHOOOHOHOOOOOHOOOHOOOOOHOHOOOHOHOH
OHHHOHHHHHHHOHOHOHHHHHOHHHHHOHHHOHOHHHHHOHOHHHOHOH
OOOOOOOOOHOOOHOHOOOOOHOHOOOHOOOHOOOOOOOHOHOOOHOHOH
HHHHHHHHOHHHHHOHHHHHOHOHOHOHOHOHHHHHHHOHOHHHOHOHOH
OOOHOOOHOOOOOOOHOOOOOHOHOHOOOHOOOHOOOHOHOOOOOHOHOH
OHOHHHOHHHHHHHHHOHHHHHOHOHHHHHHHOHOHOHHHHHOHHHOHOH
OHOOOOOOOOOOOHOHOHOOOHOHOOOHOHOOOHOHOOOOOHOOOOOHOH
OHHHHHHHHHHHOHOHOHHHOHOHHHOHOHOHHHOHHHHHOHHHHHHHOH
OHOOOHOOOHOOOOOHOOOHOOOHOOOHOOOHSOOHOOOHOOOOOOOHOH
OHOHOHOHOHHHHHHHHHOHHHHHOHHHOHHHOHHHOHOHHHHHHHOHOH
OOOHOOOHOOOOOOOOOOOOOOOOOHOOOOOHGHOOOHOOOOOOOOOOOH
HHHHHHHHHHHHHHHHHHHHHHHHHHHHHHHHHHHHHHHHHHHHHHHHHH
